अनालम्बुक->अनालम्भुक
अपोद्धर्य->अपोद्धार्य
अमृतबिन्दुपनिषद्->अमृतबिन्दूपनिषद्
अरिष्टसुदन->अरिष्टसूदन
अर्थौग->अर्थौघ
अर्धद्रोणिक->अर्धद्रौणिक
अर्पणमिमांसा->अर्पणमीमांसा
अवन्त->अवान्त
अह्नि->अह्नी
आयःशुलिक->आयःशूलिक
आर्धद्रोणिक->आर्धद्रौणिक
उदिक्षण->उदीक्षण
उपढोकन->उपढौकन
कण्टकाड्य->कण्टकाढ्य
कण्डी->काण्डी
करतली->करताली
कलन्दु->कलन्धु
काष्ठधत्रीफल->काष्ठधात्रीफल
कूटपूरि->कूटपूरी
खरीका->खारिका
खालिय->खालीय
खेटपीटमाला->खेटपीठमाला
गतश्रि->गतश्री
गन्धनाकुलि->गन्धनाकुली
गुण्डरोचनिका->गुण्डारोचनिका
जलपत्र->जलपात्र
जाह्नवि->जाह्नवी
तडित->ताडित
तबलकृति->तबलाकृति
तारचन्द्रोदय->ताराचन्द्रोदय
तुण्डिकेरि->तुण्डिकेरी
तोयादिवासिनी->तोयाधिवासिनी
त्रायन्ति->त्रायन्ती
त्रिभण्डि->त्रिभण्डी
दली->दाली
दशनक->दशनख
दशरथललितव्रत->दशरथललिताव्रत
दशैरक->दसेरक
दार्भयण->दार्भायण
दुष्या->दूष्या
द्वादशाश्रि->द्वादशास्रि
धीतिका->धीतीका
नारिकेलि->नारीकेली
नैष्टिक->नैष्ठिक
परमेशस्तोत्रावलि->परमेशस्तोत्रावली
पलङ्क्या->पालङ्क्या
पाकावलि->पाकावली
पार्थिवि->पार्थिवी
पालिन्दि->पालिन्दी
पैङ्गलौदयनि->पैङ्गलौदायनि
प्रवणी->प्रवाणी
प्रसङ्गरत्नावलि->प्रसङ्गरत्नावली
प्रेतिषणि->प्रेतीषणि
बह्रमखान->बह्रामखान
भक्तिरत्नावलि->भक्तिरत्नावली
भगवद्विलासरत्नावलि->भगवद्विलासरत्नावली
भस्मवादावलि->भस्मवादावली
भीमामाहत्म्य->भीमामाहात्म्य
भुक्त्वसुहित->भुक्त्वासुहित
भेरीक->भैरिक
भ्लश्->भ्लाश्
मथुरनाथ->मथुरानाथ
मलकोष्टक->मलकोष्ठक
महाचित्रपटल->महाचित्रपाटल
मैत्रिनाथ->मैत्रीनाथ
मौञ्जि->मौञ्जी
यमुनाचार्यस्तोत्र->यामुनाचार्यस्तोत्र
राड->राढ
रावणभेट्->रावणभैट्
रूपकतल->रूपकताल
ललाय->लालाय
लिङ्गकरणवाद->लिङ्गकारणवाद
लौहाभिसारिकप्रयोग->लौहाभिसारिकाप्रयोग
वनकार्पासि->वनकार्पासी
वरपर्णख्य->वरपर्णाख्य
वादावलि->वादावली
विस्फुर्जथु->विस्फूर्जथु
वीरनारयण->वीरनारायण
वेशिजाता->वेशीजाता
श्रेडि->श्रेडी
श्रेडि->श्रेढी
श्लघ->श्लाघ
सद्धि->सद्धी
सप्तभोम->सप्तभौम
संप्रसादन->सम्प्रसाधन
सारावलि->सारावली
सुन्दरीश्वयंवर->सुन्दरीस्वयंवर
सूपोदनषष्ठीपूजा->सूपौदनषष्ठीपूजा
सूर्यनाडि->सूर्यनाडी
सौधकर->सौधकार
स्तोत्रावलि->स्तोत्रावली
स्तोमपृष्ट->स्तोमपृष्ठ
हरिती->हारिती
हरिती->हारीती
अप्रभूती->अप्रभूति
अम्बुकेसर->अम्बुकेशर
अम्लकेसर->अम्लकेशर
अयावस्->अयवस्
अरालुक->अरलुक
अर्धी->अर्धि
अवखाण्डन->अवखण्डन
अविख्यातादोष->अविख्यातदोष
असुतार->असुतर
आपातालिका->आपतालिका
आपातालिका->आपातलिका
आयै->आये
आस्तीकार्थद->आस्तिकार्थद
इष्टराश्मि->इष्टरश्मि
उच्ची->उच्चि
उत्खा->उत्का
ऊष्मस्वेद->उष्मस्वेद
कधाप्रिय->कधप्रिय
कपाटिनी->कपटिनी
कलास->कलस
कसेरुक->कशेरुक
काणभूज->काणभुज
कालकाञ्ज्य->कालकञ्ज्य
किंपूरुष->किम्पुरुष
कुरपी->कुणपी
कूपित->कुपित
कुब्जी->कुब्जि
कुराङ्गी->कुरङ्गी
कुरीरीन्->कुरीरिन्
क्षामी->क्षमी
क्षीरीका->क्षीरिका
गम्भीरसील->गम्भीरशील
गृध्रजम्भूक->गृध्रजम्बूक
गोपजाला->गोपजला
धुनीचुमुरी->धुनीचुमुरि
नडनेरी->नडनेरि
नाभागदिष्ठ->नाभागदिष्ट
नृपजान->नृपजन
पीढ->पिड
पीथिका->पीतिका
पुत्रिकापूर्वपूत्र->पुत्रिकापूर्वपुत्र
पूर्णी->पूर्णि
फूत्कार्य->फुत्कार्य
बहुरूपागर्भस्तोत्र->बहुरूपगर्भस्तोत्र
बाडभीकार->बाडभीकर
भल्लाटशतक->भल्लटशतक
मासी->मशी
मानसापूजाविधि->मानसपूजाविधि
मितभूक्त->मितभुक्त
यज्ञानूकाशिन्->यज्ञानुकाशिन्
यातलाराय->यातलराय
युवद्धेवत्य->युवद्देवत्य
रजतपद्मादान->रजतपद्मदान
वर्गप्रशांसिन्->वर्गप्रशंसिन्
वातूलभेदादिकतन्त्र->वातुलभेदादिकतन्त्र
वातूलशुद्धागम->वातुलशुद्धागम
विपञ्चीक->विपञ्चिक
विभुप्रामित->विभुप्रमित
श्राद्धदीपकालिका->श्राद्धदीपकलिका
श्लघ->श्लग
षात्वणात्विक->षात्वणत्विक
संधी->संदी
समागामिन्->समागमिन्
समीपनायन->समीपनयन
साध्वासाधु->साध्वसाधु
सांभर->साम्बर
सिंहसैन->सिंहसेन
सुसमी->सुशमी
स्वाधीयस्->स्वादीयस्
हनूमत्कल्प->हनुमत्कल्प
अप्रतिशर->अप्रतिसर
अभिरोद्धर्->अभिरोद्धार्
अमृतप्राशिन्->अमृतप्रासिन्
अरसयितर्->अरसयितार्
अरुणय्->अरुणाय्
अर्वाक्षष्ट->अर्वाक्षष्ठ
अश्वमेधवन्त्->अश्वमेधावन्त्
अष्टपत्->अष्टपात्
असंक्रन्तिमास->असंक्रान्तिमास
असुरकाण्ड->असुरखण्ड
अहंमन->अहम्मान
आकराकर->आकारकर
आनुमति->आनुमती
आन्त्रतन्ति->आन्त्रतन्ती
आलिङ्गि->आलिङ्गी
इङ्गल->इङ्गाल
इम्मादिभारत्याचर्य->इम्मादिभारत्याचार्य
उच्ची->उच्छी
उत्पलमालभारिन्->उत्पलमालाभरिन्
उदारसत्त्वभिजन->उदारसत्त्वाभिजन
उद्भ्रु->उद्भ्रू
उपभैमि->उपभैमी
उरुक->ऊरुक
उवर्ण->ऊवर्ण
एकपुरोडश->एकपुरोडाश
एकान्नविंश->एकान्नविंस
एकान्नविंशतिधा->एकान्नविंसतिधा
कंसकेशिनिषूदन->कंसकेशीनिषूदन
काणेलिमातर्->काणेलीमातर्
कुरठ->कुराट
कुवणि->कुवरी
कुवणि->कूवरी
कौलावलि->कौलावली
क्षेपय्->क्षेपाय्
गल्लकिशिलामाहात्म्य->गल्लकीशिलामाहात्म्य
गारि->घारि
गारि->घारी
गुणदिधितिटिप्पणी->गुणदीधितिटिप्पणी
चन्द्रपृष्ट->चन्द्रपृष्ठ
चिकाण्ड->चीकाण्ड
त्रिकूटरहस्य->त्रिकूटारहस्य
त्रियज्ञ->त्रियाज्ञ
दशचिन्तामणि->दशाचिन्तामणि
दशदाश->दशदास
दावदहनज्वालाकलापय्->दावदहनज्वालाकलापाय्
धृषण->धृषाण
ध्रुवनाडि->ध्रुवनाडी
नाभु->नाभू
नारिकेलि->नारिकेली
निःशुक->निःसूक
नीलसिन्दुक->नीलसिन्धुक
पतनशील->पतनसील
पतिवंश्य->पतिवंस्य
परिक्ष->परीक्ष
परिन्दन->परीन्दन
पाशकावलि->पाशकावली
पाषण्ड्य->पाषाण्ड्य
पिडिका->पीडिका
प्रतिहानकूट->प्रतिहानाकूट
प्रशंसालप->प्रशंसालाप
प्रासङ्गवाहीवह्->प्रासङ्गवाहीवाह्
बदरिवनमाहात्म्य->बदरीवनमहात्म्य
बदरिवनमाहात्म्य->बदरीवनमाहात्म्य
भावनी->भावानी
भुरि->भूरी
मज्जाटिका->मज्जाटीका
मन्दशिशिर->मन्दशिसिर
मन्दारि->मन्दारी
यत्रकामावशायिता->यत्रकामावसायिता
लाट्य्->लाठ्य्
लाभतस्->लाभतास्
लोकविस्तर->लोकविस्तार
लोहिती->लौहिति
वनक->वानक
वन्द्यापुत्र->वन्ध्यापुत्र
वमनार्थिय->वमनार्थीय
वराहोपनह्->वराहोपानह्
वर्धमानपुराण->वर्धमानपूरण
विभ्रंशयज्ञ->विभ्रंशयाज्ञ
विमानशुद्धिपूजा->विमानसुद्धिपूजा
विशेषावश्यकनिर्युक्ति->विशेषावस्यकनिर्युक्ति
शरारिमुख->शरारीमुख
शारलोमि->शारलोमी
श्नभाश्नौष्टीय->श्नाभाश्नौष्टीय
श्रीयक->श्रीयाक
सजातीयविशिष्टान्तराघटितत्व->सजातीयविसिष्टान्तराघटितत्व
सपुरोलाश->सपुरोलास
साधारणासाधरणानुपसंहारिविरोधग्रन्थ->साधारणासाधारणानुपसंहारिविरोधग्रन्थ
साम्बाजिप्रतापराज->साम्बाजीप्रतापराज
सुजङ्ग->सुजङ्घ
हिक्काश्वसिन्->हिक्काश्वासिन्
अन्तश्चाण्डाल->अन्तश्चण्डाल
अमाङ्गलिक->अमङ्गलिक
अलातशान्ति->अलातशन्ति
अव्याद->अव्यध
असांवत्सर->असंवत्सर
आपारि->आपणि
आर्चनानस->आर्चनानश
उज्य->उज्ञ
उद्भ्रु->उद्ब्रू
उल्मुकावक्षयण->उल्मुकवक्षयण
उष्ट्रवामी->उष्ट्रवामि
एकाकिकेसरिन्->एकाकिकेशरिन्
ऐतवाध्र्य->एतवाध्र्य
ऐलि->एलि
ऐलि->एली
ओकारी->ओकणि
ओकारी->ओकणी
कठकालाप->कठकलाप
कर्णपूरी->कर्णपुरी
कसेरुमन्त्->कशेरुमन्त्
कसेरूमन्त्->कशेरुमन्त्
कसेरुयज्ञ->कशेरुयज्ञ
कुपाल->कुपल
कुरूत्थाम->कुरूत्तम
केसरापीड->केशरापीड
केसरोच्चटा->केशरोच्चटा
क्षीराय्->क्षीरय्
खादताचामता->खादताचमता
घ्राणचक्षुस्->घ्राणचक्षुश्
चित्राङ्गसादन->चित्राङ्गसदन
चिन्मात्राकाशिका->चिन्मात्रकाशिका
जङ्गह्->जङ्गः
जझ्झ->जज्झ
जलघटी->जलघटि
जानकीरामचन्द्रविलास->जानकीरमचन्द्रविलास
जिनप्रभासूरि->जिनप्रभसूरि
ज्ञौदानीय्->ज्ञौदनीय्
झणझ्झणिति->झणज्झणिति
झुम्बरी->झुम्बरि
तडाकिनी->तडाकिनि
तालाक->तलाक
तल्पसद्य->तल्पशद्य
तूबरीका->तुबरिका
तूबरीका->तूबरिका
त्रिखण्डिकासूत्र->त्रिकण्डिकासूत्र
धुन्->दूङ्
द्युमौर्वी->द्युमौर्वि
धाराशीत->धाराशित
ध्रुवनाडि->ध्रुवनडि
ध्रुवनाडि->ध्रुवनडी
नाम्रा->नम्रा
नासोत्थ->नसोत्थ
नागाट्टायिक->नागाट्टयिक
नाटकाख्यायिकादर्शन->नाटकाख्यायिकदर्शन
नाभिकूपिका->नाभिकुपिका
न्यासी->न्यसी
न्यासी->न्यासि
परिहारम्->परिहाणम्
पादशुश्रूषा->पादशुश्रुषा
पादादिमध्यायमक->पादादिमध्ययमक
पीढ->पिढ
पुण्यकूट->पुण्यकुट
पुरीषमूत्रप्रतीघात->पुरीषमूत्रप्रतिघात
पैङ्गलौदयनि->पैङ्गलोदायनि
पौतिमत्स्यक->पोतिमत्स्यक
प्रियजानी->प्रियजानि
प्रौढी->प्रोढि
बस्ताभिवासिन्->बस्ताभिवाशिन्
मासी->मशि
मषीधानी->मषीधनी
महानघ्नी->महानग्नी
मिथ्याधीत->मिथ्याधित
मेघपालीतृतीयाव्रत->मेघपालितृतीयाव्रत
मौदाकि->मोदकी
मौदाकि->मोदाकी
यवबूसक->यवबुसक
रङ्गेष्ठालु->रङ्गेष्टालु
वंशपात्री->वंशपत्री
वज्राण्डी->वज्राण्डि
वनकार्पासि->वनकार्पसि
वनकार्पासि->वनकार्पसी
वराभिधा->वरभिधा
विमलसरस्वती->विमलसरस्वति
विषी->विषि
वीतत्रासरेणु->वीतत्रसरेणु
वेटावन्त्->वेटवन्त्
वेणिकावाहिन्->वेणिकवाहिन्
व्यङ्गुली->व्यङ्गुलि
शक्रकाष्ठा->शक्रकष्ठा
शंकरकिंकरीभाव->शंकरकिंकरीभव
शमनीचामेढ्र->शमनीचमेढ्र
शंभूराजचरित्र->शंभुराजचरित्र
शंभूराजचरित्र->शम्भुराजचरित्र
शास्त्रातिग->शस्त्रातिग
शुद्धमध्यामार्गी->शुद्धमध्यमार्गी
शूर्पवीणा->शूर्पविणा
श्रीदामानन्ददात्री->श्रीदामनन्ददात्री
श्रुतनिगादिन्->श्रुतनिगदिन्
श्रुतिनिगादिन्->श्रुतिनिगदिन्
संहतिशालिन्->संहतिशलिन्
सञ्चाल->सञ्चल
सदान्वाक्षयण->सदान्वक्षयण
सदान्वाचातन->सदान्वचातन
समवायी->समवायि
संप्रसाधन->सम्प्रसादन
सर्वासंभव->सर्वसम्भव
सहस्ततालम्->सहस्ततलम्
सागरबुद्धिधार्यभिज्ञागुप्त->सागरबुद्धिधार्यभिज्ञगुप्त
सांख्ययोगवादिन्->सांख्ययोगवदिन्
सुभद्रापूर्वज->सुभद्रपूर्वज
स्तम्भी->स्तम्बि
स्तम्भी->स्तम्भि
स्थेयी->स्तेयि
स्थेयी->स्तेयी
स्थलपथी->स्थलपति
स्वायंभूक्षेत्रमाहात्म्य->स्वयम्भूक्षेत्रमाहात्म्य
अंशुमन्त्->अंसुमन्त्
अग्निष्टोमहोत्र->अग्निष्टोमहौत्र
अदमुयञ्च्->अदमूयञ्च्
अनड्वह्->अनड्वाह्
अन्दोलय्->अन्दोलाय्
अपचित्->अपाचित्
अपची->अपाची
अपठ->अपाठ
अपण्य->अपार्य
अपति->अपाती
अपद्->अपाद्
अपधा->अपादा
अपधा->अपाधा
अपभ्रंश->अपभ्रंस
अपमित्य->अपामित्य
अपमृत्यु->अपामृत्यु
अपरकाशि->अपरकाशी
अपरपर->अपरापर
अपरभाव->अपराभव
अपराङ्मुख->अपराङ्मूख
अपरिजात->अपारिजात
अपलित->अपालित
अपलित->अफलित
अपवरक->अपवारक
अपवर्तन->अपावर्तन
अपवारण->अपावरण
अपशु->अपसू
अपशु->अपासु
अपश्य->अपास्य
अपश्री->अपाश्रि
अपस्->अपास्
अपसरण->अपासरण
अपसारण->अपासरण
अपसी->अपासि
अपस्कर->अपस्कार
अपस्तम्ब->अपस्तम्भ
अपस्य->अपास्य
अपाटव->अपाठव
अपांनप्त्रिय->अपांनप्त्रीय
अपाष्टि->अपाष्ठि
अपृष्ट->अपृष्ठ
अपोगण्ड->अपौगण्ड
अपोनप्त्रिय->अपोनप्त्रीय
अप्पदीक्षित->अप्पादीक्षित
अप्रज->अप्राझ
अप्रतिघ->अप्रतीघ
अप्सरस्->अफ्सरस्
अप्सुवह्->अप्सुवाह्
अबण्ड->अभाण्ड
अबधा->अबाधा
अबधिर->अबधीर
अबध्य->अबाध्य
अबल->अबाल
अबीज->अभिज
अबीज->अभिझ
अभव्य->अभाव्य
अभिकर->अभिकार
अभिक्रम->अभिक्राम
अभिघात->अभीघात
अभिचरणीय->अभिचारणीय
अभिचरित->अभिचारित
अभिजात->अभिझात
अभिज्ञ->अभीज्य
अभिज्ञानशकुन्तल->अभिज्ञानशाकुन्तल
अभितरम्->अभितराम्
अभिनिष्टान->अभिनिष्ठान
अभिप्रेप्सु->अभिप्रेफ्सु
अभिभवन->अभिभावन
अभिभु->अभिभू
अभिमर्द->अभिमर्ध
अभिमर्दिन्->अभिमर्धिन्
अभिमातिषह्->अभिमातिषाह्
अभियाति->अभियाती
अभिलाप->अभीलाप
अभिव्यक्ति->अभिव्यक्ती
अभिशङ्क्य->अभिसङ्ख्य
अभिशपन->अभिशापन
अभिशस्->अभिशास्
अभिषच्->अभिषाच्
अभिषह->अभिषाह
अभिष्टि->अभीष्टि
अभिसर->अभीसार
अभिसरण->अभिसारण
अभिसार->अभीसार
अभीपद->अभीपाद
अभीषह्->अभीषाह्
अभ्यागारम्->अभ्याघारम्
अभ्युपगम->अभ्युपागम
अभ्रि->अभ्री
अमनुष्य->अमानुष्य
अमन्तु->अमन्थु
अमम->अमाम
अमम्रि->अमम्री
अमल->अमाल
अमस->अमास
अमामसी->अमामासी
अमावस्या->अमावास्या
अमित->अमीत
अमृतमति->अमृतमती
अमृतसू->अमृताशु
अम्ब्->अंभ्
अम्ब->अम्भ
अम्ब->अंभ
अम्बरिष->अंबरीष
अम्बि->अम्बी
अम्बुकण्टक->अम्बुकण्ठक
अम्बुदेव->अम्बुदैव
अम्बुधर->अम्बुधार
अयज्ञसच्->अयज्ञसाच्
अयज्ञिय->अयज्ञीय
अयत->अयात
अयति->अयाति
अयथ->अयात
अयथापूर्व->अयातपूर्व
अयवक->अयावक
अयवन्->अयावन्
अयवाह->अयावह
अयोपाष्टि->अयोपाष्ठि
अरणि->अरणी
अरण्य->अरर्य
अरण्यवास्तुक->अरण्यवास्तूक
अरण्यानि->अरण्यानी
अरति->अरथि
अररक->अरराक
अरालि->अराली
अरिष्ट->अरिष्ठ
अरुन्धतीवट->अरुन्धतीवाट
अर्तन->अर्थन
अर्ति->अर्थि
अर्ति->अर्थी
अर्धकील->अर्धखिल
अर्धखार->अर्धाकार
अर्धहार->अर्धाहार
अर्शस->अर्सस
अर्हरिष्वणि->अर्हरिष्वाणि
अलक->अलाक
अलजि->अलजी
अलाबु->अलाबू
अलि->अली
अलिगर्द->अलिगर्ध
अलिन->अलीन
अलिपक->अलीपक
अल्पबाध->अल्पाबाध
अवकर->अवाकर
अवगुण->अवगुर
अवचय->अवचाय
अवचर->अवचार
अवतरणिका->अवतारणिका
अवदानीय->अवधानीय
अवदार->अवधार
अवदेय->अवधेय
अवध->अवाद
अवधि->अवधी
अवधि->अवादी
अवनति->अवनती
अवनिप->अवनीप
अवनिरुह->अवनीरुह
अवन्तिपुर->अवन्तीपुर
अवन्तिब्रह्म->अवन्तीब्रह्म
अवन्तिसुन्दरी->अवन्तीसुन्दरी
अवन्तिसोम->अवन्तीसोम
अवबधा->अवबाधा
अवमान->अवामन
अवरतस्->अवारतस्
अवलम्ब->अवालम्ब
अवस्->अवास्
अवसर->अवसार
अवस्कर->अवस्कार
अविक->अवीक
अविक्षित->अवीक्षित
अविचलित->अविचालित
अविद्य->अविध्य
अविपाल->अविफल
अविरत->अविरथ
अविस्तर->अविस्तार
अवीचि->अवीची
अव्यवस्त->अव्यवस्थ
अशन्->अशान्
अशन->अशान
अशनि->अशनी
अशेव->अशैव
अश्रद्दधान->अश्रद्धधान
अश्वमुख->अश्वामुख
अश्वयु->अश्वायु
अष्टनिधन->अष्टानिधन
अष्टपद्->अष्टपाद्
अष्टपद्->अष्टापाद्
अष्टपद->अष्टापाद
अष्टपाद->अष्टापाद
अष्टमङ्गल->अष्टमाङ्गल
अष्टर्च->अष्टार्च
अष्टस्तना->अष्टास्तना
अष्टापद्->अष्टापाद्
अष्टापद->अष्टापाद
अष्टाश्रि->अष्टास्रि
असक्ति->असक्थि
असनि->असानि
असंभव्यम्->असंभाव्यम्
असहिष्णु->असाहिष्णु
असि->असी
असुख->असूक
असुर->असूर
असुसू->असूसू
असूसु->असूसू
अस्कन्द->अस्कन्ध
अस्ताग->अस्थाघ
अस्ताघ->अस्थाघ
अस्ति->अस्ती
अस्ति->अस्थी
अस्तिता->अस्थिता
अस्त्रकण्टक->अस्त्रकण्ठक
अस्थाग->अस्थाघ
अस्थि->अस्थी
अस्ववेश->अस्वावेश
अह्->आः
अहत->अहात
अहीरणि->अहीरणी
आकरिन्->आकारिन्
आके->आकै
आगत->आगथ
आगा->आघा
आगुर्->आगूर्
आगुरण->आगूरण
आग्निदत्तेय->आग्निदात्तेय
आग्रयणेष्टि->आग्रायणेष्टि
आघाटि->आघाटी
आङ्गि->आङ्गी
आच्->आछ्
आच->आछ
आचरण->आचारण
आजातशत्रव->आजातशात्रव
आजुर्->आजूर्
आज्ञप्ति->आज्ञाप्ति
आडि->आडी
आडिबक->आडीबक
आणि->आरि
आतपन->आतापन
आति->आती
आत्मगत->आत्मघात
आत्मगति->आत्मघाती
आदम्->आधम्
आदान->आधन
आदारिन्->आधारिन्
आदि->आदी
आदिकर->आदिकार
आदित्व->आधित्व
आदित्सु->आधित्सु
आद्य->आध्य
आधुनिक->आधूनिक
आनकदुन्दुभि->आनकदुन्दुभी
आनन्दलहरि->आनन्दलहरी
आनन्दि->आनन्दी
आनिलि->आनिली
आनिलि->आनीली
आन्तरिक्ष->आन्तरीक्ष
आपदेव->आपादेव
आपस्तम्ब->आपस्तम्भ
आपि->आपी
आबल्य->आबाल्य
आभीरपल्लि->आभीरपल्ली
आभ्याशिक->आभ्यासिक
आमल->आमाल
आमलक->आमालक
आम्लिका->आम्लीका
आयति->आयती
आयत्ति->आयत्ती
आयमन->आयमान
आरट्ट->आरट्ठ
आरट्टज->आरठ्ठज
आरस->आरास
आरुणि->आरुणी
आरुह्->आरूः
आर्चिक->आर्चीक
आर्द->आर्ध
आर्षभि->आर्षभी
आलम्बिन्->आलंभिन्
आलि->आली
आलु->आलू
आलोकमथुरानाथी->आलोकमाथुरानाथी
आवत्->आवात्
आवभृत्य->आवभृथ्य
आवलि->आवली
आवसति->आवसथी
आविद्->आविध्
आवुक->आवूक
आवेशिक->आवैशिक
आशर->आशार
आशस्->आशास्
आशा->आसा
आशि->आशी
आशि->आसि
आशिन->आशीन
आशिर्->आशीर्
आशिस्->आशीस्
आशिस्->आसीस्
आशीतिक->आसीतिक
आशु->आशू
आशु->आसु
आशु->आसू
आशुशुक्षणि->आशुशुक्षणी
आश्रव->आश्राव
आश्रि->आश्री
आश्वतराश्वि->आश्वतरास्वि
आश्वबल->आश्वबाल
आषाढभव->आषाढाभव
आषाढि->आषाढी
आसदन->आसाधन
आसनी->आसानी
आसादन->आसाधन
आसुरि->आसुरी
आस्तिक्य->आस्तीक्य
आस्फोट->आस्फोठ
आहुत->आहूत
इङ्ग्->ईङ्ग्
इज्य->ईज्य
इञ्ज्->ईञ्ज्
इड->ईड
इड->ईढ
इडा->ईडा
इत्->ईत्
इत->ईत
इतस्->इथस्
इत्कट->इत्कठ
इन्->ईङ्
इन्दुफल->इन्दूपल
इन्दुमणि->इन्दुमणी
इन्द्रतुरीय->इन्द्रतूरीय
इन्द्रवह्->इन्द्रवाह्
इयक्ष्->ईयक्ष्
इयम्->ईयम्
इयम्->ईयाम्
इरा->ईरा
इराज->ईरज
इरिका->ईरिका
इल्->ईL
इल्->ईल्
इलिका->ईलिका
इलिनी->ईलिनी
इली->ईली
इल्लिश->इल्लिस
इल्लिश->इल्लीस
इषीकतूल->इषीकातूल
इषुपथ->इषुपात
इषेत्वक->इषेत्वाक
इस्->ईस्
इहवन्त्->ईहावन्त्
ईक्षणिक->ईक्षणीक
ईलि->ईली
ईश्->ईस्
उकनाह->उकानह
उक्ति->उक्थि
उक्थशस्->उक्थशास्
उक्षण->उक्षाण
उच्च->उच्छ
उच्चल->उच्छल
उच्चावच->उच्चावाच
उच्छ्वसित->उच्छ्वासित
उञ्छशिल->उञ्छशील
उट->उठ
उड्र->उढ्र
उण्डुक->उण्डूक
उत्कुण->उत्कुर
उत्कूर्दन->उत्कूर्दान
उत्क्रम->उत्क्राम
उत्खली->उत्खाली
उत्तपन->उत्तापन
उत्तब्ध->उत्थब्ध
उत्तरकामाख्यतन्त्र->उत्तरकामाख्यातन्त्र
उत्तरतन्त्र->उत्तरातन्त्र
उत्तरफल्गुनी->उत्तरफाल्गुनी
उत्तरवेदि->उत्तरवेदी
उत्तरोष्ठ->उत्तरौष्ठ
उत्पादशयन->उत्पादशयान
उत्पुत->उत्पूत
उत्सधि->उत्सादि
उत्सर->उत्सार
उत्सादन->उत्साधन
उद->उध
उदकधर->उदकाधार
उदन्त->उदान्त
उदपू->उदापु
उदप्लुत->उदाप्लुत
उदवाह->उदावह
उदसन->उदासन
उदहार->उदाहर
उदाप्यम्->उदाप्याम्
उदास->उधस
उदित->उदीत
उद्गता->उद्गाता
उद्गल->उद्गाल
उद्गिरण->उद्गीरण
उद्दान->उद्धन
उद्देश्यविधेयबोधस्थलीयविचार->उद्देश्यविधेयबोधस्थालीयविचार
उद्धि->उद्धी
उद्धुषण->उद्धूषण
उद्य->उध्य
उद्यति->उद्यती
उद्वपन->उद्वापन
उन्दन->उन्दान
उपक्रम्य->उपक्राम्य
उपक्वण->उपक्वाण
उपगत->उपागत
उपगम्य->उपागम्य
उपगा->उपागा
उपघात->उपागत
उपचय->उपचाय
उपचरण->उपाचरण
उपतपन्त्->उपतापन्त्
उपदश->उपदास
उपदा->उपादा
उपदा->उपाधा
उपदान->उपधन
उपदान->उपाधान
उपदिश्->उपादिश्
उपदी->उपधी
उपधा->उपादा
उपधा->उपाधा
उपधान->उपाधान
उपधि->उपधी
उपधेय->उपाधेय
उपध्मा->उपाध्मा
उपनहन->उपनाहन
उपभृत्->उपाभृत्
उपरोध->उपारोध
उपलक्ष्य->उपालक्ष्य
उपलभ्य->उपालभ्य
उपलिङ्ग->उपालिङ्ग
उपलिप्सु->उपालिप्सु
उपविद्->उपविध्
उपशिंहन->उपसिंहन
उपश्री->उपाश्रि
उपस्->उपाश्
उपस्->उपास्
उपसद्->उपसाध्
उपसद्->उपासद्
उपसद्य->उपसाद्य
उपसद्य->उपासाद्य
उपस्ति->उपस्थि
उपस्था->उपास्था
उपस्थित->उपास्थित
उपहरण->उपाहरण
उपहार->उपाहार
उपा->ऊपा
उपादान->उपाधान
उपादेय->उपाधेय
उपित->उफित
उभयदन्त्->उभयादन्त्
उभयपद्->उभयापद्
उमाकट->उमाकठ
उरूक->ऊरुक
उर्वङ्ग->ऊर्वङ्ग
उर्वारु->उर्वारू
उर्विया->उर्वीया
उल->ऊल
उलपराजि->उलपराजी
उलुपिन्->उलूपिन्
उलुपिन्->ऊलूपिन्
उलूक->ऊलूक
उवट->ऊवट
उवे->ऊवे
उशिज->ऊसिज
उशीर->उसीर
उषण->उषर
उष्णय्->उष्णाय्
उस्रिय->उस्रीय
उह्->ऊः
ऊति->ऊती
ऊर्जवह->ऊर्जवाह
ऊर्णनाभि->ऊर्णनाभी
ऊर्णम्रदस्->ऊर्णाम्रदस्
ऊर्ध्वदंष्ट्रकेश->ऊर्ध्वदंष्ट्राकेश
ऊर्मि->ऊर्मी
ऊर्वष्टीव->ऊर्वष्ठीव
ऊलुपिन्->ऊलूपिन्
ऋच्->ऋछ्
ऋतनि->ऋतनी
ऋतयु->ऋतायु
ऋतसप्->ऋतसाप्
ऋताषह्->ऋताषाह्
ऋति->ऋती
ऋतीषह्->ऋतीषाह्
ऋतु->ऋथु
ऋश्यपद्->ऋश्यपाद्
ऋषि->ऋषी
ऋषिवत्->ऋषीवत्
एककर->एकाकर
एककर->एकाकार
एकपद्->एकपाद्
एकपदि->एकपदी
एकपर->एकपाण
एकवीरकल्प->एकवीराकल्प
एकवेणि->एकवेणी
एकशितिपद्->एकशितिपाद्
एकान्त->ऐकान्त
एकावलि->एकावली
एडुक->ऐडुक
एडूक->ऐडुक
एण->एर
एणनाभि->एणनाभी
एतवे->एतवै
एद्->ऐध्
एध्->ऐध्
एला->ऐला
एलुक->एलूक
एषण->एषाण
एषवीर->एषावीर
ऐणिकीय->ऐणीकीय
ऐन्द्रि->ऐन्द्री
ऐश्वरि->ऐश्वरी
ओक->ओख
ओक्य->औख्य
ओणि->ओणी
ओतवे->ओतवै
ओषधि->ओषधी
ओषधिपति->औषधीपति
ओषधीपति->औषधीपति
ओषसी->औषसी
ओष्ठ्य->औष्ठ्य
ओष्ण->औष्ण
औग्रसेनि->औग्रसेनी
औदर->औदार
औदुम्बरि->औदुम्बरी
औपगवि->औपगवी
औपनिषद->औपनिषध
औरसि->औरसी
और्ध्वदेहिककल्पवल्लि->और्ध्वदेहिककल्पवल्ली
औशीनरि->औशीनरी
औशीनरि->औसीनरि
कंसवती->कंसावती
ककुद्मन्->ककुद्मान्
कक्षपुट->कक्षापुट
कक्षी->काक्षी
कङ्क->काङ्क
कङ्करोल->कङ्करौल
कङ्कोल->काङ्कोल
कङ्ख->काङ्क
कङ्गु->कङ्गू
कङ्गुल->काङ्गुल
कङ्गुल->काङ्गूल
कच्->काच्
कच्चर->कच्छर
कच्छप->काच्छप
कञ्च्->काञ्च्
कञ्चिका->काञ्चिका
कञ्चुल->कञ्चूल
कञ्चुलिका->कञ्चुलीका
कञ्जर->कञ्जाण
कञ्जिका->काञ्जिका
कटक->कठक
कटम्बरा->कटंभरा
कटम्बरा->कटम्भरा
कटार->काटर
कटि->कठि
कटि->कठी
कटिसूत्र->कटीसूत्र
कटी->कठि
कटी->कठी
कठर->काटर
कणिक->काणिक
कणीक->काणिक
कणेरु->करेणू
कण्टकार->काण्टकार
कण्टकाल->कण्ठकाल
कण्टकिल->कण्टाकिल
कण्टिन्->कण्ठिन्
कण्ठगत->कण्ठागत
कण्ठला->कण्ठाला
कण्डरीक->काण्डरिक
कण्व->काण्Vअ
कण्वोपनिषद्->काण्वोपनिषद्
कत->कथ
कद->कध
कदम्बयुद्ध->कादम्बयुद्ध
कदर->कदार
कदल->कादल
कद्रु->कद्रू
कद्रुज->कद्रूज
कद्रुण->कद्रूण
कधि->कादि
कनी->कानी
कन्थरी->कान्तारी
कन्था->कान्ता
कन्थारी->कान्तारी
कन्द->कन्ध
कन्दर->कन्धर
कपटिक->कापटिक
कपल->कफल
कपाल->कफल
कपालि->कपाली
कपालि->कापाली
कपि->कफी
कपिकच्छु->कपिकच्छू
कपिकच्छु->कपीकच्छू
कपिकच्छुफलोपमा->कपिकच्छूफलोपमा
कपिकच्छुरा->कपिकच्छूरा
कपिल->कफिल
कपिलधारा->कपिलाधारा
कपिष्ठल->कपिष्ठाल
कपीकच्छु->कपीकच्छू
कपोतपालि->कपोतपाली
कबर->काबर
कम्->काम्
कमन्तक->कामान्तक
कमलवती->कमलावती
कमा->कामा
कमि->कामी
कम्पिल->कम्पील
कम्बु->कंबू
कम्बु->कंभु
कम्बु->कम्भू
कम्बुक->काम्बुक
कम्बू->कंभु
कम्बू->कम्भू
कम्बूक->काम्बुक
कम्भु->कम्भू
कयस्था->कायस्था
कयाधु->कयाधू
कय्य->काय्य
करकण्टक->करकण्ठक
करग्रह->करग्राह
करणत्व->कारणत्व
करणि->करणी
करद्वीप->काराद्वीप
करन्थ->करान्त
करमर्द->करामर्ध
करशीकर->करसीकर
करस्थ->कारास्थ
करस्फोट->करास्फोट
करामर्द->करामर्ध
करि->काणि
करि->कारी
करिक->काणिक
करी->काणि
करी->कारी
करुणमल्ली->करुणामल्ली
करूकर->कारुकर
करेणु->करेणू
करोटक->कारोटक
करोटि->करोटी
कर्कटक->कार्कटक
कर्कटि->कर्कटी
कर्कन्धु->कर्कन्धू
कर्कर->कर्कार
कर्करि->कर्करी
कर्कि->कर्की
कर्कि->कार्कि
कर्किप्रस्थ->कर्कीप्रस्थ
कर्केतण->कर्केतर
कर्कोटकि->कर्कोटकी
कर्णन्दु->कर्णान्दू
कर्णप्रतिनाह->कर्णप्रतीनाह
कर्णमोटि->कर्णमोटी
कर्णाकर्णि->कर्णाकर्णी
कर्णाटक->कार्णाटक
कर्णान्दु->कर्णान्दू
कर्णिक->कार्णिक
कर्बु->कर्बू
कर्मक्षम->कर्माक्षम
कर्मणि->कर्मरी
कर्मण्य->कार्मार्य
कर्मण्यभुज्->कर्मण्याभुज्
कर्मरक->कार्मणक
कर्मरक->कार्मारक
कर्मान्तिक->कार्मान्तिक
कर्मारक->कार्मणक
कर्मारक->कार्मारक
कर्व->काण्Vअ
कलचुरि->कलचूरि
कलम->कलाम
कलश->कलस
कलशि->कलशी
कलशि->कलसि
कलशि->कलसी
कलशीसुत->कलसीसुत
कलशोदर->कलसोदर
कलि->कली
कलिद्रुम->कलिद्रूम
कल्लट->कल्लाट
कवटी->कवाटी
कवारि->कवारी
कवि->कवी
कव्यवह्->कव्यवाह्
कशिपु->कसिपु
कश्मल->कस्मल
कस्तुरिका->कस्तूरिका
काकजम्बु->काकजम्बू
काकण->काकर
काकणि->काकणी
काकनि->काकनी
काकन्दि->काकान्दी
काकन्दी->काकान्दी
काकलि->काकली
काकि->काकी
काकिणिक->काकिणीक
काकु->काकू
काकोलि->काकोली
काकोष्ठक->काकौष्ठक
काक्षि->काक्षी
काङ्गा->काङ्घा
काण्ठेविद्धि->काण्ठेविद्धी
कान्तिक->कान्तीक
कापालि->कापाली
कापोति->कापोती
कामचर->कामाचार
कामचार->कामाचार
कामन्दकि->कामन्दकी
कामलि->कामली
कामशर->कामसार
कामाशन->कामासन
कामि->कामी
काम्बोजि->काम्बोजी
कारकर->काराकार
काराधुनि->काराधुनी
कारि->कारी
कार्मणिक->कार्मारिक
कार्षि->कार्षी
कार्ष्णि->कार्ष्णी
कालनेमि->कालनेमी
कालरात्रि->कालरात्री
काललोह->काललौह
कालशेय->कालसेय
कालायनि->कालायनी
काशय->काशाय
काशि->कासी
काशिराम->कासीराम
काशी->कासी
काशीपति->कासीपति
काशीराम->कासीराम
काश्मरी->कास्मरी
काश्यप->कास्यप
काश्यपि->काश्यपी
काष्ठलोहिन्->काष्ठलौहिन्
काहलि->काहली
कि->की
किंशारु->किंसारु
किकि->किकी
किकिदीवि->किकीदिवि
किकिदीवि->किकीदीवि
किक्किश->किक्किस
किङ्कणी->किङ्करी
किङ्किणि->किङ्किणी
किङ्किणि->किङ्किरी
किङ्किणीकाश्रम->किङ्कीणिकाश्रम
किटि->कीटी
किणि->किणी
किम्पल->किम्फल
किंपुरुष->किम्पूरुष
किराति->किराती
किरिटि->किरिटी
किरिटि->किरीटी
किर्मी->कीर्मी
किशोर->किसोर
कुक्कुटि->कुक्कुटी
कुज्जिश->कुज्झिश
कुज्झटि->कुज्झटी
कुञ्जराशन->कुञ्जरासन
कुट्->कुठ्
कुट्->कूट्
कुटि->कूटि
कुटि->कूटी
कुटी->कूटि
कुटी->कूटी
कुट्टल->कुट्टाल
कुठि->कूटि
कुठि->कूटी
कुण->कुर
कुण->कूण
कुणक->कुरक
कुणावी->कुरवी
कुणिक->कूणिक
कुनदीक->कुनादिक
कुन्त->कुन्थ
कुन्दरिका->कुन्दारिका
कुप्->कूप्
कुपय->कूपाय
कुपिनी->कूपिनी
कुम्भि->कुंभी
कुम्भि->कुम्भी
कुम्भीनसि->कुम्भीनसी
कुयव->कूयव
कुरङ्गनाभि->कुरङ्गनाभी
कुरट->कुराट
कुरर->कुरार
कुरुपञ्चाल->कुरुपाञ्चाल
कुर्चिका->कूर्चिका
कुलपालि->कुलपाली
कुलभवन->कुलभावन
कुलस्तम्ब->कुलस्तम्भ
कुलहण्डक->कूलहण्डक
कुलाल->कूलाल
कुलि->कुली
कुलिक->कुलीक
कुलीका->कूलिका
कुल्या->कूल्या
कुवर->कूवर
कुवेणि->कुवेणी
कुश->कुस
कुशर->कुसर
कुशल->कुसल
कुशाल->कुसल
कुशि->कुशी
कुशि->कुसी
कुशिक->कुसिक
कुशिम्बि->कुशिम्बी
कुशिम्बि->कुसिम्बी
कुशीति->कुशीती
कुशोदका->कुसोदका
कुसि->कुसी
कुसितायी->कुसीतायी
कुसुमशर->कुसुमसर
कुसुम्बक->कुसुम्भक
कुह्->कूः
कुहलि->कुहली
कुहुरव->कुहूराव
कुहूरव->कुहूराव
कूटतुला->कूटतूला
कूटशाल्मलि->कूटशाल्मली
कूर्मपुराण->कूर्मपूराण
कूर्मि->कूर्मी
कूश्माण्ड->कूस्माण्ड
कृञ्->कॄञ्
कृत्->कॄत्
कृत->कॄत
कृतदार->कृतधार
कृतरथ->कृतरात
कृतसपत्निका->कृतसापत्नीका
कृतसापत्निका->कृतसापत्नीका
कृताञ्जलि->कृताञ्जली
कृति->कृती
कृथ->कॄत
कृपाणि->कृपाणी
कृमि->कृमी
कृवि->कृवी
कृषि->कृषी
कृष्णगङ्गा->कृष्णागङ्गा
कृष्णहारित->कृष्णहारीत
कृष्णिय->कृष्णीय
केकय->केकाय
केकर->केकाण
केकेयी->कैकेयी
केतसप्->केतसाप्
केतुमालि->केतुमाली
केनार->कैनर
केलि->केली
केश->केस
केशवादित्य->केशावादित्य
केशारि->केसरी
केशि->केशी
केसरि->केसरी
कैरली->कैराली
कोकिलहोत्र->कोकिलहौत्र
कोङ्कण->कोङ्कार
कोङ्काण->कोङ्कार
कोटर->कोठर
कोटि->कोटी
कोटि->कोठी
कोटिकर्ण->कोटीकर्ण
कोणाकोणि->कोणाकोणी
कोण्डभट्ट->कौण्डभट्ट
कोम->कौम
कोर->कौर
कोर्प्य->कौर्प्य
कोलि->कोली
कोलि->कौली
कोलि->खोली
कोल्लपुर->कोल्लापुर
कोश->कोस
कोहलीय->कौहलिय
कौज->खोज
कौण्य->कौर्य
कौदालिक->कौदालीक
कौमुदिका->कौमुदीका
कौरव्यायणि->कौरव्यायणी
कौरुजङ्गल->कौरुजाङ्गल
कौलि->कौली
कौलि->खोली
कौशलि->कौशली
कौशलि->कौसली
कौशाम्बि->कौशाम्बी
कौशाम्बि->कौशांबी
कौशिक->कौशीक
कौषीतकि->कौषीतकी
कौष्य->खोष्य
क्रकचपद्->क्रकचपाद्
क्रकरट->क्रकराट
क्रमिक->क्रामिक
क्रय->क्राय
क्रयि->क्रयी
क्रयिक->क्रायिक
क्रेणि->क्रेणी
क्रोञ्चपदी->क्रौञ्चपादी
क्रौञ्चपदी->क्रौञ्चपादी
क्रौञ्चादन->क्रौञ्चादान
क्वयि->क्वयी
क्षणदाचर->क्षणदाचार
क्षणदेश->क्षारदेश
क्षणित->क्षरित
क्षणित->क्षारित
क्षत्रिय->क्षात्रिय
क्षप्->क्षाप्
क्षमता->क्षामता
क्षमत्व->क्षामत्व
क्षस्->क्षास्
क्षान्ति->क्षान्ती
क्षिपणि->क्षिपणी
क्षुण->क्षूण
क्षुद->क्षुध
क्षुद्रकण्टिका->क्षुद्रकण्ठिका
क्षुद्रवर्वणा->क्षुद्रवर्वरा
क्षुर->क्षूण
क्षेत्रिय->क्षेत्रीय
क्षेपणि->क्षेपणी
क्षेमफला->क्षेमाफला
क्षोणि->क्षोणी
क्षोणि->क्षौणि
क्षोणि->क्षौरी
क्षोणिपति->क्षोणीपति
क्षौणी->क्षौरी
क्ष्णु->क्ष्णू
खङ्कर->खङ्खर
खङ्ख->खाङ्क
खङ्खण->खङ्खर
खङ्गाह->खाङ्गाह
खञ्जन->खाञ्जन
खट->खाट
खटिक->खटीक
खट्टाश->खट्टास
खट्वाङ्गधर->खट्वाङ्गधार
खड्गधर->खड्गाधार
खड्गिक->खाड्गिक
खड्गिन्->खाड्गिन्
खड्गीक->खाड्गिक
खदिका->खादिका
खनि->खनी
खनि->खानी
खनिनेत्र->खनीनेत्र
खमूलि->खमूली
खरमञ्जरि->खरमञ्जरी
खरिका->खारिका
खरी->खारी
खरीजङ्घ->खारीजङ्घ
खरु->खाणु
खरोष्टी->खरोष्ठी
खर्जु->खर्जू
खर्परिका->खर्परीका
खर्वुरा->खर्वूरा
खल्लि->खल्ली
खशीर->खासीर
खसाक->खासक
खसीक->खाशिक
खस्फटिक->खस्फाटिक
खाटि->खाटी
खानि->खानी
खारि->खारी
खाशीर->खासीर
खुड्डक->खुड्डाक
खुर्द्->खूर्द्
खोटि->खोटी
खोलि->खोली
खोल्मुक->खोल्मुख
ख्याति->ख्याती
गङ्गदत्त->गङ्गादत्त
गङ्गाटेय->गाङ्गटेय
गज->गाज
गजवाज->गाजवाज
गजवीथि->गजवीथी
गजानन->गजानान
गडिक->गाडिक
गड्डुक->गड्डूक
गणि->गरि
गणि->गरी
गण्डु->गण्डू
गण्डुल->गण्डूल
गद->गध
गदाभृत्->गधाभृत्
गदि->गदी
गन्तवे->गन्तवै
गन्दिका->गन्धिका
गन्धमदन->गन्धमाधन
गन्धमादन->गन्धमाधन
गन्धर्वराज->गन्धर्वाराज
गन्धशुण्डिनी->गन्धाशुण्डिनी
गन्धारि->गन्धारी
गभस्ति->गभस्ती
गमिन्->गमीन्
गमिष्ठ->गमीष्ठ
गयशिरस्->गयाशिरस्
गर्ग->गर्घ
गर्दभि->गर्दभी
गर्दभि->गर्धभि
गर्भावतरण->गर्भावतारण
गर्मुटिका->गर्मूटिका
गलु->गलू
गवाशन->गवासन
गविनी->गवीनि
गविनी->गवीनी
गविष्टि->गविष्ठि
गाञ्जिकाय->गाञ्जीकाय
गाढमुष्टि->गाढमुष्ठि
गाथानी->घातनी
गान्दी->गान्धी
गान्धारि->गान्धारी
गायत्रि->गायत्री
गार->घण
गार->घर
गारक->घाणक
गार्ग्यायणि->गार्ग्यायणी
गार्तक->घार्तक
गार्भ->घर्ब
गालि->गाली
गाह्->घः
गिर्->गीर्
गिर->घिण
गिरि->गिरी
गिरि->घिणि
गिरियक->गिरियाक
गिर्ववह्->गिर्ववाह्
गिल्->घिल्
गीत->गीथ
गीर्वाणपदमञ्जरि->गीर्वाणपदमञ्जरी
गुङ्गु->गुङ्गू
गुटिका->घुटिका
गुड->घुड
गुडक->गूढक
गुडुची->गुडूची
गुडोदक->गूढोदक
गुण->गुर
गुण->गूर
गुण->घुर
गुण->घूर
गुणक->घुणक
गुणी->गुरी
गुणी->गूरी
गुणी->घुरी
गुणी->घूरी
गुण्डाशिनी->गुण्डासिनी
गुद->गुध
गुप्ति->गुप्ती
गुर्द्->गूर्ध्
गुलुञ्च->गुलुञ्छ
गुह्->गूः
गुह्->घुः
गुह->गूह
गूढ->घुड
गूढपद्->गूढपाद्
गूर्द्->गूर्ध्
गूह्->घुः
गृण्डिव->गृण्डीव
गृत्सतमस्->घृत्सतमस्
गृत्समद->घृत्समद
गृद->गृध
गृहचुल्ली->गृहचूल्ली
गृहदीप्ति->गृहादीप्ति
गृहभर्तर्->गृहभार्तर्
गृहशुक->गृहाशुक
गृहु->गृहू
गो->गौ
गोकक्ष->गौकाक्ष
गोकिल->गोकील
गोड->घोड
गोण->घोण
गोणिका->गौरिका
गोणिका->घोरिका
गोतमान्वय->गौतमान्वय
गोद->गौद
गोदा->गोधा
गोदाय->गोधाय
गोध->गौद
गोपयितव्य->गोपायितव्य
गोपालि->गोपाली
गोपालि->गौपालि
गोपिक->गोपीक
गोपिल->गोफिल
गोपिल->गौफिल
गोबल->गोबाल
गोभिल->गौभिल
गोमति->गोमती
गोमति->गौमती
गोयूति->गोयूथी
गोरण->घोरण
गोरथ->गौरथ
गोरस->घोणस
गोरिका->गौरिका
गोरिका->घोरिका
गोर्द->गोर्ध
गोवर्धनीय->गौवर्धनीय
गोशे->गोसे
गोषादी->घोषादि
गोष्ट्->गोष्ठ्
गोष्ठि->गोष्ठी
गोष्ठि->गौष्ठी
गोह्य->गौह्य
गौकक्ष->गौकाक्ष
गौड->घोड
गौण->घोण
गौणत्व->घोरत्व
गौतमि->गौतमी
गौपिलेय->गौफिलेय
गौर->घोण
गौरत्व->घोरत्व
गौरी->घोणी
गौरी->घोरी
गौला->घोला
ग्रन्थकुटी->ग्रन्थकूटी
ग्रन्थविस्तर->ग्रन्थविस्तार
ग्रस्->घ्रस्
ग्रहणि->ग्रहणी
ग्रहि->ग्राही
ग्रामचर->ग्रामाचार
ग्रामटिका->ग्रामाटिका
ग्रावस्तोत्रिया->ग्रावस्तोत्रीया
ग्राहि->ग्राही
घटाल->घाटल
घटालाबु->घटालाबू
घटि->घटी
घटि->घाटि
घटिघट->घटीघट
घटीका->घाटिका
घण्टक->घाण्टक
घण्टाक->घाण्टक
घण्टापाटलि->घण्टापाटली
घनरव->घनाराव
घनारव->घनाराव
घर्घुर्घा->घर्घूर्घा
घर्मतनु->घर्मतनू
घर्माम्बु->घार्माम्बु
घुण->घुर
घुण->घूर
घुणि->घुरी
घुणि->घूरी
घुर्घुरक->घुर्घूरक
घोणा->घोरा
घोलि->घोली
चक्रनेमि->चक्रनेमी
चटुल्लोल->चटूल्लोल
चतु->चतू
चतुःसन->चतुह्सन
चतुरश्र->चतुरस्र
चतुरश्रक->चतुरस्रक
चतुरश्रता->चतुरस्रता
चतुराश्रम्य->चतुराश्राम्य
चतुर्थि->चतुर्थी
चतुर्दशगुणनामन्->चतुर्दशगुणानामन्
चतुष्पदी->चतुष्पादी
चत्वर्->चत्वार्
चन्द्रगिरि->चन्द्रगिरी
चन्द्रभास->चन्द्राभास
चन्द्रलोहक->चन्द्रलौहक
चन्द्रवशा->चन्द्रवासा
चन्द्रवसा->चन्द्रवासा
चन्द्रशीता->चन्द्रसीता
चन्द्राकर->चन्द्राकार
चन्द्रि->चन्द्री
चमत्करण->चमत्कारण
चमसि->चमसी
चमुपति->चमूपति
चरणि->चारणी
चरि->चरी
चरि->चारी
चरित->चारित
चर्व्->चार्व्
चर्षणि->चर्षणी
चल्->छल्
चलता->छलता
चलातङ्क->चलातङ्ख
चलि->चाली
चलि->छाली
चली->चाली
चली->छाली
चवि->चवी
चवि->छावी
चशाल->चसाल
चह्->छः
चह्->छाः
चाङ्ग->छङ्ग
चाट->छाट
चाणक->छरक
चाणक->छाणक
चातुर्विद्य->चातुर्वीद्य
चातुर्विध्य->चातुर्वीद्य
चात्र->छत्र
चात्र->छात्र
चान्द्रभागा->छन्द्रभागा
चान्द्रभागि->चान्द्रभागी
चान्द्रमस->चान्द्रमास
चान्द्रि->चान्द्री
चाप->छप
चायु->छयु
चारक->छरक
चारक->छाणक
चारुमति->चारुमती
चाष->छष
चिक->चीक
चिकरिषु->चिकारिषु
चिकित्वन्->चिकित्वान्
चिक्कण->छिक्कण
चिचीकुची->चीचीकुची
चिच्चिटिङ्ग->चिच्छिटिङ्ग
चिणी->चीरी
चित्->चीत्
चित्->छित्
चित्रवहा->चित्रवाहा
चित्रशाकपूपभक्ष्यविकारक्रिया->चित्रशाकापूपभक्ष्यविकारक्रिया
चित्रसङ्ग->चित्रासङ्ग
चित्रिय->चित्रीय
चिरण्टी->चिरण्ठी
चिरम्भण->चीराम्बर
चिरि->चीरी
चिरिटीक->चिरीटीक
चिरिण्टी->चिरिण्ठी
चिलिचिम->चिलिचीम
चिलिचिम->चिलीचिम
चिल्लक->चील्लक
चिल्लि->चिल्ली
चीनपिष्ट->चीनपिष्ठ
चीरि->चीरी
चीरिल्लि->चीरील्लि
चुचु->चुचू
चुचु->चूचु
चुचुक->चूचूक
चुचुन्दरी->छुछुन्दरी
चुचूक->चूचूक
चुच्चु->चुच्चू
चुच्चु->छुच्छू
चुञ्चुलि->चुञ्चुली
चुट्ट्->छुट्ट्
चुड्->चुढ्
चुर->चूण
चुर->चूर
चुर->छुर
चुरु->चुरू
चुल्लि->चुल्ली
चूचुक->चूचूक
चूड->छुड
चेतकी->चैतकि
चेतय->चेताय
चेद्->छेद्
चेदि->चेदी
चेदि->छेदी
चेदिक->छेदिक
चैत्ररथि->चैत्ररथी
चैत्रि->चैत्री
चैदिक->छेदिक
चौण्ट्य->चौण्ठ्य
चौण्ड्य->चौण्ढ्य
छत्त्रधान्य->छत्त्राधान्य
छन्दु->छन्दू
छन्दोग->छन्दोघ
छन्दोमञ्जरि->छन्दोमञ्जरी
छन्द्य->छान्द्य
छर्दापनिका->छर्दापनीका
छर्दिका->छर्दीका
छवि->छावी
छुच्छु->छुच्छू
छुच्छुन्दर->छुच्छून्दर
छेकल->छेकाल
छेदि->छेदी
छोटि->छोटी
जगर->जगार
जघन->जघान
जघन->जाघन
जङ्गल->जङ्घल
जङ्गाल->जङ्घल
जङ्गिड->जङ्गीड
जज्ज->जज्झ
जटामांसी->जाटामांसी
जटि->जटी
जटोच्च->जटोच्छ
जतु->जतू
जतूकर्ण->जातुकर्ण
जनकरी->जनकारी
जनकसुता->जनकासुता
जनत्->जानत्
जनन->जानन
जनन->जानान
जननि->जननी
जनार्दन->जानार्दन
जनिदा->जनिधा
जनु->जनू
जमदग्नि->जामदग्नि
जम्बु->जम्बू
जम्बुवनज->जम्बूवनज
जम्बूनदी->जाम्बूनदी
जम्बूलमालिका->जाम्बूलमालिका
जय->जाय
जयघोष->जयाघोष
जयादित्य->जयाधित्य
जयितर्->जायितर्
जरक->जारक
जरण->जरर
जरणा->जारणा
जरद्गववीथि->जारद्गवावीथि
जरस->जरास
जरित->जारित
जरिन्->जारिन्
जलजम्बुका->जलजम्बूका
जलधि->जलधी
जलधि->जालधि
जलब्रह्मी->जलब्राह्मी
जलभूषण->जालभूषण
जलमार्ग->जालमार्ग
जलवास->जलावास
जलशायिन्->जलाशायिन्
जलाषह्->जलाषाह्
जलिका->जालिका
जलेश्वर->जालेश्वर
जव->जाव
जवाल->जावाल
जविन->जवीन
जहल्लक्षणा->जहाल्लक्षणा
जहिस्तम्ब->जहिस्तम्भ
जह्नावी->जाह्नवी
जाङ्गलि->जाङ्गली
जाङ्गलिक->जाङ्गलीक
जाङ्गुलि->जाङ्गुली
जाजलि->जाझालि
जातकर्मन्->जातकार्मन्
जातवेदस्->जातावेदस्
जातिफल->जातीफल
जानकि->जानकी
जामि->जामी
जाम्बवोष्ठ->जाम्बवौष्ठ
जालपद्->जालपाद्
जिङ्गी->जिङ्घि
जितकाशिन्->जितकासिन्
जिर्वि->जीर्वि
जिहिति->जिहीति
जीवग्रह->जीवग्राह
जीवनि->जीवनी
जीवन्ति->जीवन्ती
जीवादान->जीवाधान
जु->झु
जुड्->जूड्
जुष->झूष
जू->झु
जूष->झूष
जेह्->झेः
जैमिनीयन्यायमालाविस्तर->जैमिनीयन्यायमालाविस्तार
ज्ञता->ज्ञाता
ज्ञानकाण्ड->ज्ञानखण्ड
ज्ञानोत्तम->ज्ञानौत्तम
ज्ञुबाध्->ज्ञुभाध्
ज्योति->ज्योती
ज्योतिःष्टोम->ज्योतिःष्ठोम
ज्योतिरथा->ज्योतीरथा
ज्योतिषिक->ज्योतिषीक
ज्योत्स्नी->ज्यौत्स्नी
ज्रि->ज्री
ज्वलमुखी->ज्वालामुखी
ज्वलिनी->ज्वालिनि
ज्वलिनी->ज्वालिनी
झंकार->झांकार
झंकारिन्->झांकारिन्
झटि->झाटि
झण्डुक->झण्डूक
झर्च्->झर्छ्
झर्झरीक->झार्झरिक
झलरी->झालरी
झाटल->झाटाल
झाटिका->झाटीका
झावु->झावू
झिण्टि->झिण्टी
झिरिका->झिरीका
झिल्लिक->झील्लिक
झिल्लीक->झील्लिक
टक्क->ठक्क
टक्कदेशीय->टक्कादेशीय
टङ्कण->टङ्कार
टङ्कण->टाङ्कर
टङ्कण->टाङ्कार
टंकृत->टांकृत
टाक->ठक
टिट्टिभ->टीट्टिभ
टिण्टिणिका->टिण्टिणीका
टुण्टुक->टुण्ठुक
टोट->टौट
ट्वल->ट्वाल
डकर->डकार
डकर->ढकार
डम्ब्->डंभ्
डहु->डहू
डाहुक->डाहूक
डिल्लि->डिल्ली
डिल्लि->ढिल्ली
डोर->ढौर
ढण्टी->ढण्ठी
णि->णी
तकरि->तकरी
तङ्क्->ताङ्क्
तड्->ताड्
तण्ड्->तर्ड्
तण्डि->तण्डी
ततत्व->तथात्व
ततर->ततार
तत्काल->तात्काल
तथागत->ताथागत
तद्देवत्य->तद्दैवत्य
तनक->तानक
तन्ति->तान्ति
तन्ती->तान्ति
तन्त्रवाप->तन्त्रावाप
तन्त्रि->तन्त्री
तन्थी->तान्ति
तन्द्रि->तन्द्री
तन्नि->तन्नी
तन्वि->तन्वी
तपती->तापती
तपोमूर्ति->तपोमूर्ती
तपोरति->तपोराति
तमि->तमी
तमि->तामी
तर्->तार्
तरणि->तरणी
तरस्->तरास्
तरस्थान->तारस्थान
तर्क->तार्क
तर्णि->तार्णि
तर्पण->तर्पर
तर्पिलि->तर्पिली
तलक->तलाक
तलबद्ध->तालबद्ध
तादयनि->तादायनि
तामि->तामी
ताम्रपर्णि->ताम्रपर्णी
ताम्रोष्ठ->ताम्रौष्ठ
तारनाथ->तारानाथ
तालन->तालान
तालापचर->तालापचार
तालावचर->तालावचार
तिक->तीक
तिण्टी->तिण्ठी
तिथि->तिथी
तिन्तिलिका->तिन्तिलीका
तिम->तीम
तिमि->तिमी
तिर्->तीर्
तिलकय->तिलकाय
तिलखलि->तिलखली
तिलोदन->तिलौदन
तीक्ष्णलोह->तीक्ष्णलौह
तीरग्रह->तीरग्राह
तीर्थसेनि->तीर्थसेनी
तुणि->तूरी
तुण्डि->तुण्डी
तुन्दि->तुन्दी
तुम्बि->तुम्बी
तुरम्->तूरम्
तुरि->तूरी
तुरी->तूरी
तुर्फरि->तुर्फरी
तुर्यवह्->तुर्यवाह्
तुर्व->तूर्व
तुलसि->तुलसी
तुलाकोटि->तुलाकोटी
तुलाप्रग्रह->तुलाप्रग्राह
तुलि->तुली
तुलि->तूली
तुलिका->तूलिका
तुविष्टम->तुविष्ठम
तुहर->तुहार
तूणि->तूरी
तूणिन्->तूरिन्
तूणी->तूरी
तूर्णि->तूर्णी
तूलि->तूली
तृणकुटि->तृणकुटी
तृणजलायुका->तृणजलायूका
तृतीयप्रकृति->तृतीयाप्रकृति
तृप्->तृफ्
तृप->तृफ
तेजस्विनितमा->तेजस्विनीतमा
तेदनि->तेदनी
तेन->तैङ
तैत्तिरिक->तैत्तिरीक
तैलद्रोणी->तैलद्रौणी
तोक->तौक
तोयडिम्ब->तोयडिम्भ
तोलकेशि->तौलकेशि
तोलन->तौलन
त्यद->त्याद
त्यदायनि->त्यादायनि
त्रिंशद्योगावलि->त्रिंशद्योगावली
त्रिदशश्रेष्ठ->त्रिदशस्रेष्ठ
त्रिपद->त्रिपाद
त्रिपदिका->त्रिपादिका
त्रिपाट->त्रिपाठ
त्रिपुण्ड्र->त्रिपुण्ढ्र
त्रिपुरद्रुह्->त्रिपुरद्रूह्
त्रिपुरसिद्धान्त->त्रिपुरासिद्धान्त
त्रिभङ्गि->त्रिभङ्गी
त्रिलोहक->त्रिलौहक
त्रिवलि->त्रिवली
त्रिवेणि->त्रिवेणी
त्रिशरण->त्रिसरण
त्रिशानु->त्रिसानु
त्रिसंधि->त्रिसंधी
त्रुटि->त्रुटी
त्रुप्->त्रुफ्
त्रोटि->त्रोटी
त्र्यश्र->त्र्यस्र
त्र्युषण->त्र्यूषण
त्वच->त्वाच
थुथुकृत्->थुथूकृत्
थुर्व्->थूर्व्
दंशुक->दंशूक
दंशेर->दंसेर
दकाण->दकार
दक्षि->दक्षी
दक्षि->दाक्षी
दक्षिणपूर्व->दक्षिणापूर्व
दक्षिणा->दाक्षिणा
दडी->दाडि
दण्डकल->दण्डकाल
दण्डनायक->दाण्डनायक
दण्डय्->दण्डाय्
दण्डवासिक->दाण्डवासिक
दत्त->दत्थ
ददन->दधान
दद्रुरोगिन्->दद्रूरोगिन्
दधन->दधान
दधिशर->दधिसर
दन्तक->दान्तक
दन्तशिरा->दन्तसिरा
दन्तालि->दन्ताली
दन्ति->दन्ती
दन्तोष्ठक->दन्तौष्ठक
दन्त्योष्ठ्य->दन्त्यौष्ठ्य
दम्->दाम्
दमक->दामक
दमन->दामन
दमिन्->दामिन्
दंपति->दम्पती
दंपति->दंपती
दम्भ->दाम्भ
दय्->दाञ्
दयावीर->दायविर
दर्->दाण्
दर->दाण
दरणि->दारणी
दरि->दरी
दरि->दाणि
दरि->दारी
दरित->दारित
दर्द्रु->दर्द्रू
दर्द्रुघ्न->दर्द्रूघ्न
दर्भपिञ्जुल->दर्भपिञ्जूल
दर्वि->दर्वी
दर्वि->दार्वी
दर्विक->दर्वीक
दर्व्य->दार्व्य
दर्शक->दार्शक
दर्शपूर्णमास->दर्शपूर्णामास
दलि->दाली
दवानल->दावानल
दशति->दशती
दशति->दासति
दशन->दसन
दशनोच्छिष्ट->दशनोच्छिष्ठ
दशपार्श्व->दशापार्श्व
दशबन्ध->दाशबन्ध
दशमान->दसमान
दशमाय->दशामय
दशशिरस्->दाशशिरस्
दशार्ह->दासर्ह
दशेरक->दसेरक
दहनीय->दाहनीय
दाक्षायणि->दाक्षायणी
दाक्षि->दाक्षी
दातवे->दातवै
दारि->दारी
दालि->दाली
दाशार्ह->दासर्ह
दासेरकि->दासेरकी
दिण्ण->दीर्ण
दित्यवह्->दित्यवाह्
दिदी->दीदी
दिधि->दीदी
दिधिषु->दिधिषू
दिधिषु->दिधीषु
दिनकृत्->दीनकृत्
दिननाथ->दीननाथ
दिनमुख->दीनमुख
दिनादि->दीनधी
दिवन्->दीवान्
दिवाकीर्त्य->दीवाकीर्त्य
दिवावसु->दिवावासु
दिव्यमान->दीव्यमान
दिश->दीस
दिह्->दीः
दीक्षापाल->दीक्षाफल
दीदि->दीदी
दीपवती->दीपावती
दीपावलि->दीपावली
दीर्घपद्->दीर्घपाद्
दुःशक->दुःशाक
दुद->दुध
दुन्दुभि->दुन्दुभी
दुन्दुभिस्वन->दुन्दुभिस्वान
दुन्दुभिस्वर->दुन्दुभीश्वर
दुराक्रम->दुराक्राम
दुराश->दुरास
दुरोणयु->दुरोणायु
दुर्गटीका->दुर्गाटीका
दुर्गन्धि->दुर्गन्धी
दुर्गसंचर->दुर्गसंचार
दुर्गह->दुर्गाह
दुर्दर->दुर्दार
दुर्बल->दुर्बाल
दुर्वचक->दुर्वाछक
दुर्वस->दुर्वास
दुलि->दुली
दुलि->दूली
दुश्च्यवन->दुश्च्यावन
दुष्->दूष्
दुष्->धूष्
दुष्पार्ष्णिग्रह->दुष्पार्ष्णिग्राह
दुह्->धुः
दुह्->धूः
दूणश->दूणास
दूणाश->दूणास
दूत->धुत
दूति->धुति
दूती->धुति
दून->धुन
दूर->धूर
दूरी->धूरी
दूर्व->धुर्व
दूष->धूष
दूषण->धूषर
दूस->धूश
दूस->धूस
दृक->धृक
दृढक्षत्र->दृढक्षात्र
दृढच्युत->दृढाच्युत
दृढधन्विन्->दृढधान्विन्
दृढनेमि->धृढनेमि
दृढभक्ति->दृढाभक्ति
दृढसेन->धृढसेन
दृति->धृती
दृशि->दृशी
दृष्टिविष->दृष्टीविष
देवकर्मन्->दैवकर्मन्
देवता->दैवता
देवतीर्थ->दैवतीर्थ
देवदर्श->देवादर्श
देवदूति->देवदूती
देवनन्दा->देवानन्दा
देवनिद्->देवनीद्
देवपद->देवपाद
देवपुत्र->दैवपुत्र
देवभूत->दैवभूत
देवयजि->देवयाजी
देवयु->देवायू
देवयुग->दैवयुग
देवयू->देवायू
देवराज्य->दैवराज्य
देववत्->देवावत्
देववध->दैववाद
देववीति->देववीती
देवव्रत->देवव्रात
देवसख->दैवसक
देवायु->देवायू
देविदास->देवीदास
देविन्->दैविन्
देवेज्य->दैवेज्य
देशक->देशाख
दैवाकरि->दैवाकरी
दोर्ग्रह->दौर्ग्रह
दोलयात्रा->दोलायात्रा
दोस्->दौश्
दौहित्रायण->दौहित्रायाण
द्युति->द्युती
द्युतिमति->द्युतिमती
द्यो->द्यौ
द्योभूमि->द्योभूमी
द्रविण->द्राविण
द्रव्य->द्राव्य
द्रह->द्राह
द्रुणि->द्रुणी
द्रुमवल्क->द्रुमवाल्क
द्रुह्->द्रूः
द्रेष्कण->द्रेष्काण
द्रोणि->द्रोणी
द्रोणि->द्रौणि
द्रोणीज->द्रौणीज
द्रौणायन->द्रौणायान
द्वादशकर->द्वादशाकार
द्वादशांश->द्वादशांस
द्वादशीव्रत->द्वादसीव्रत
द्विचतुरश्रक->द्विचतुरस्रक
द्वितीयतन्त्र->द्वितीयातन्त्र
द्वितीयिक->द्वितीयीक
द्वित्र->द्वीत्र
द्विपद्->द्विपाद्
द्विबर्हस्->द्विबर्हास्
द्विवर्षक->द्विवार्षक
द्वैवर्षिक->द्वैवार्षिक
धननाश->धननास
धनिक->धानिक
धनुष->धानुष
धनुष्कोटि->धनुष्कोटी
धनुष्खाता->धानुष्कता
धनेयक->धानेयक
धन्यक->धान्याक
धन्याक->धान्याक
धमनि->धमनी
धरणि->धरणी
धरणि->धारणी
धरणीय->धारणीय
धरापति->धारपति
धर्मभगिनी->धर्मभागिनी
धर्मयु->धर्मायु
धर्षणि->धर्षणी
धवनी->धावनी
धातकि->धातकी
धातुरत्नमञ्जरि->धातुरत्नमञ्जरी
धानका->धानाका
धान्यक->धान्याक
धामशस्->धामसश्
धामसच्->धामसाच्
धारणि->धारणी
धारय->धाराय
धारि->धारी
धावनि->धावनी
धिष्ट्य->धिष्ठ्य
धुन्धुरि->धुन्धुरी
धुर->धूर
धुरि->धूरी
धुस्तुर->धूस्तुर
धुस्तूर->धूस्तुर
धूण->धूर
धूम्राक्षि->धूम्राक्षी
धूर्षह्->धूर्षाह्
धूलिपटल->धूलीपटल
धृति->धृती
धोरणि->धोरणी
धोरित->धौरित
धौति->धौती
ध्यानजप्य->ध्यानजाप्य
ध्रु->ध्रू
ध्वंसि->ध्वंसी
ध्वनि->ध्वनी
ध्वनित->ध्वानित
नक्षत्रवादावलि->नक्षत्रवादावली
नखारि->नाकारि
नखि->नखी
नखि->नाकी
नगरमर्दिन्->नागरमर्दिन्
नगररक्षिन्->नगाररक्षिन्
नगस्वरूपिणी->नागस्वरूपिणी
नगारि->नागरी
नग्नजित्->नाग्नजित्
नग्नहु->नग्नहू
नटसूत्र->नाटसूत्र
नड्->नाड्
नडक->नाडक
नति->नाति
नद्->नध्
नदि->नदी
नदीमुख->नदीमूख
नदेयी->नादेयी
नद्धि->नद्धी
नन्दकि->नन्दकी
नन्दि->नन्दी
नन्दि->नान्दि
नन्दिक->नन्दीक
नप्ति->नप्ती
नभनु->नभनू
नमि->नामि
नमी->नामि
नम्र->नाम्र
नर्->नार्
नरकपाल->नारकपाल
नरसिंह->नारसिम्ह
नरसिंहपुराण->नारसिंहपुराण
नराशन->नरासन
नरीय->नारीय
नर्दटक->नर्धटक
नलकिनी->नालकिनि
नलगिरि->नालागिरि
नलिन->नालिन
नलिनी->नालीनी
नवति->नवती
नवाश्र->नवास्र
नष्टचेष्ट->नष्टचेष्ठ
नष्टि->नष्टी
नहि->नही
नाकुलि->नाकुली
नागवल्लि->नागवल्ली
नागालाबु->नागालाबू
नागोजि->नागोजी
नाग्नजिति->नाग्नजिती
नाटिन्->नाटीन्
नाभि->नाभी
नामग्रह->नामग्राह
नारायणि->नारायणी
नारि->नारी
नारिष्ट->नारीष्ट
नारिष्ठ->नारीष्ट
नार्यङ्ग->नार्याङ्ग
नालन्द->नालान्द
नालि->नाली
नालिजङ्घ->नालीजङ्घ
नालिनी->नालीनी
नावप्रभ्रंशन->नावप्रभ्रांशन
नाविक->नावीक
नाहुषि->नाहुषी
निःशस्->निःशास्
निःशाण->निःसर
निःशूक->निःसूक
निःश्रेणि->निःश्रेणी
निःषमम्->निःषामम्
निःसरत्व->निःसारत्व
निःसुख->निःसूक
निःस्वन->निःस्वान
निकष->निकाष
निकाश->निकास
निक्वण->निक्वाण
निगण->निगर
निजधृति->निजधृती
नितान्तवृक्षीय->नितान्तावृक्षीय
निदानसूत्र->निधनसूत्र
निधनता->निधानता
निपुण->निपुर
निबिड->निभिड
निबिडय्->निभिडय्
निरंशक->निरंसक
निरय->निराय
निरशन->निराशन
निरसन->निराशन
निरुष्मत्व->निरूष्मत्व
निर्गुण->निर्घुण
निर्गुण्टी->निर्गुण्ठी
निर्गुण्डि->निर्गुण्डी
निर्बाध्य->निर्भद्य
निर्मथ->निर्मात
निर्मथ->निर्माथ
निर्माण->निर्मार
निर्वहण->निर्वाहण
निर्वेद->निर्वेध
निलय->निलाय
निलय->नीलाय
निवरण->नीवरण
निवर्तयितव्य->निवर्तयीतव्य
निवारण->नीवरण
निवृत->नीवृत
निशमय->निशामय
निशा->नीशा
निशाण->नीसाण
निशित->निसित
निशिता->निशिथा
निशिथ->निसित
निशीथ->निसित
निशुम्भ->निसुम्भ
निश्राविन्->निस्राविन्
निश्वसित->निश्वासित
निश्वास->निस्वास
निषदन->निषधन
निष्करूष->निष्कारुष
निष्कलि->निष्कली
निष्कुटि->निष्कुटी
निष्क्रम->निष्क्राम
निष्टि->निष्ठी
निष्पत्ति->नीष्पत्ति
निष्पद्->निष्पाद्
निष्पद->नीष्पद
निष्पावि->निष्पावी
निष्षह्->निष्षाह्
निसर->नीसाण
निसार->नीसाण
निसुन्द->निसुन्ध
निह्नुवन->निह्नुवान
नीपातिथि->नीपातीथि
नीरज->नीराज
नीरशन->नीरसन
नीलपोर->नीलपौर
नीलमणि->नीलमाणि
नीललोह->नीललौह
नीलस्कन्दा->नीलस्कन्धा
नीवि->नीवी
नीशार->नीसाण
नीषह्->नीषाह्
नृजित्->नृजीत्
नृति->नृती
नृपति->नृपती
नृषच्->नृषाच्
नृषह्->नृषाह्
नेपथ्य->नैपथ्य
नेपालक->नैपालक
नेमि->नेमी
नेल->नैल
नेष्->नैष्
नेष्ट->नैष्ट
नैयमिक->नैयामिक
नैरृति->नैरृती
नैषादि->नैषादी
नोधस्->नोधास्
न्यङ्कुभूरुह->न्यङ्कुभूरूह
न्यायनिबन्ध->न्यायनिभन्ध
न्यायविद्या->न्यायाविद्या
पंश्->पंस्
पक्ति->पक्ती
पक्षति->पक्षती
पखोद->पखौद
पङ्कग्राह->पङ्खग्राह
पङ्कमण्डुक->पङ्कमण्डूक
पङ्कशूरण->पङ्कसूरण
पचन->पचान
पञ्चतप->पञ्चातप
पञ्चपदी->पञ्चपादी
पञ्चमुष्टि->पञ्चमुष्टी
पञ्चशर->पञ्चसार
पञ्चशर->पञ्चाशर
पञ्चशिल->पञ्चशील
पञ्चाङ्गुलि->पञ्चाङ्गुली
पञ्चाश्व->पञ्चास्व
पञ्जि->पञ्जी
पटत्->पठत्
पटि->पटी
पटु->पटू
पट्टावलि->पट्टावली
पट्टिश->पट्टिस
पणधा->परादा
पणन->परान
पणाया->पराया
पतिन्->पथिन्
पत्ति->पत्ती
पत्त्राङ्गुलि->पत्त्राङ्गुली
पत्त्रावलम्बन->पत्त्रावलाम्बन
पत्त्रावलि->पत्त्रावली
पद्धति->पद्धती
पद्मकर->पद्माकार
पद्माकर->पद्माकार
पद्यावलि->पद्यावली
पनु->पनू
पन्थन्->पन्थान्
पन्नगारि->पन्नागारि
परःश्वस्->परःस्वस्
परक्रान्ति->पराक्रान्ति
परगत->परागत
परण->पराण
परतन्त्र->परातन्त्र
परता->परथा
परपुरुष->परपूरुष
परभूत->पराभूत
परभृत->पराभृत
परमर्षि->परमार्षि
परमेष्ठि->परमेष्ठी
परशुधर->परशुधार
परश्वध->परस्वध
परस्तरम्->परस्तराम्
परायति->परायती
परास->पारश
परास->पारास
परासु->परासू
परासु->पारासु
परि->परी
परि->पाणी
परि->पारि
परि->पारी
परिकर->परिकार
परिक्षि->परिक्षी
परिखा->पाणिका
परिगृहीत->पाणिगृहीत
परिगृहीति->पाणिगृहीती
परिग्रह->पाणिग्राह
परिग्रहक->पाणिग्राहक
परिग्रहवन्त्->पाणिग्राहवन्त्
परिग्रहिन्->पाणिग्राहिन्
परिग्राह->पाणिग्राह
परिग्राहक->पाणिग्राहक
परिचय->परिचाय
परिचर्य->परिचार्य
परिणमन->परिणामन
परिणय->परिरय
परिणय->पारिणाय
परिणह्->पारीणः
परिणाय->परिरय
परिणाय->पारिणाय
परिदा->परिधा
परिदा->परीदा
परिधाविन्->परीधाविन्
परिपदिन्->परिपदीन्
परिपाटि->परिपाटी
परिपान->पारिपान
परिपीडा->पाणिपीडा
परिभोग->परीभोग
परिमत्->परिमथ्
परिमत्->पाणिमत्
परिमल->परीमल
परिवृत->परीवृत
परिवेद्य->पारिवेद्य
परिव्रज्य->परिव्राज्य
परिव्राजि->परिव्राजी
परिषद्->पारिषद्
परिष्वजन->परिष्वजान
परिसर->परिसार
परीक्षिति->पारिक्षिती
परीणह्->पारीणः
परीणाय->पारिणाय
परु->परू
परुद्वार->परूद्वार
परे->पारे
पर्कटि->पर्कटी
पर्णकार->पर्णाकर
पर्णरुह्->पर्णरूह्
पर्णसि->पर्णासि
पर्येहि->पर्येही
पर्व->पार्व
पर्वणिका->पर्वणीका
पर्वति->पार्वती
पर्वती->पार्वती
पर्शुल->पर्शूल
पल्->पाल्
पलालिन->पालालिन
पलाशक->पालशक
पल्लि->पल्ली
पवनाशनाश->पवनाशनास
पवित->पावित
पश्चिमानूपक->पाश्चिमानूपक
पष्ठवह्->पष्ठवाह्
पांशुराष्ट्र->पांसुराष्ट्र
पाकलि->पाकली
पाञ्चयज्ञिक->पाञ्चयाज्ञिक
पाञ्चलिका->पाञ्चालिका
पाञ्चलोहितिक->पाञ्चलौहितिक
पाटन->पाठान
पाटलिपुत्र->पाटलीपुत्र
पाटुपट->पाटूपट
पाठन->पाठान
पाणि->पाणी
पाणि->पारि
पाणि->पारी
पाणिग्रह->पाणिग्राह
पाणिग्रहणीय->पाणिग्राहणीय
पाण्डुसोपाक->पाण्डुसौपाक
पातक->पाताक
पातवे->पातवै
पाति->पाती
पाति->पाथि
पात्रीण->पात्रीर
पादपालिका->पादफलिका
पादशस्->पादशाश्
पादाङ्गुलि->पादाङ्गुली
पापक->पापाक
पायिक->पायीक
पारस->पारास
पारावताङ्घ्रि->पारावताङ्घ्री
पारावति->पारावती
पाराशरि->पाराशरी
पाराशरिन्->पारासरिन्
पारिजात->पारीजात
पारिपाट्य->पारिपाठ्य
पारिश->पारीश
पारुच्छेपि->पारुच्छेपी
पारुष्ण->पारूष्ण
पार्वति->पार्वती
पार्ष्णि->पार्ष्णी
पार्ष्णिवह्->पार्ष्णिवाह्
पावकि->पावकी
पाशी->पासी
पिङ्गललोह->पिङ्गललौह
पिच्च्->पिच्छ्
पिच्चा->पिच्छा
पिञ्जल->पिञ्जाल
पिञ्जुल->पिञ्जूल
पिट->पिठ
पिटक->पिटाक
पिटक्या->पिटाक्या
पिठरक->पीठरक
पिण्डदान->पिण्डादान
पिण्डल->पिण्डाल
पिण्डालु->पिण्डालू
पिपासवन्त्->पिपासावन्त्
पिपिली->पिपीली
पिप्पलि->पिप्पली
पिप्पलिश्रोणि->पिप्पलीश्रोणि
पिप्पिका->पिप्पीका
पिम्परि->पिम्परी
पिश->पिस
पिशङ्ग->पिसङ्ग
पिशाचि->पिशाची
पिशिताशन->पिशितासन
पीतवासस्->पीतवासास्
पीतशाल->पीतसाल
पीति->पीती
पीति->पीथी
पीथि->पीथी
पीलु->पीलू
पुंसक->पुंसाक
पुञ्जिकस्थला->पुञ्जिकास्थला
पुण्->पूर्
पुणिक->पूरिक
पुण्यगन्ध->पुण्यगान्ध
पुत->पुथ
पुनर्वसु->पुनर्वसू
पुर्->पूर्
पुर->पूण
पुरजित्->पुराजित्
पुरंध्रि->पुरंध्री
पुरय->पूरय
पुरस्->पुरास्
पुराकृत->पूरकृत
पुरारि->पूरणी
पुरासह्->पुरासाह्
पुरि->पुरी
पुरि->पूरी
पुरिका->पूरिका
पुरु->पुरू
पुरुषदन्तिका->पुरूषदन्तिका
पुरुहुत->पुरूहूत
पुरुहूत->पुरूहूत
पुरोगा->पुरोघा
पुरोटि->पूरोटि
पुरोडाश्->पुरोडास्
पुलकी->पुलाकी
पुलिक->पूलिक
पुलीका->पूलिका
पुष्करशिका->पुष्करशिखा
पुष्पवत्->पुष्पावत्
पूण्->पूर्
पूति->पूती
पूतिकरज->पूतीकरज
पूपलिका->पूपालिका
पूयवह->पूयवाह
पूर्वचित्ति->पूर्वचित्ती
पूर्वदेहिक->पूर्वदैहिक
पूर्वभद्रपद->पूर्वभाद्रपद
पूर्ववह्->पूर्ववाह्
पृच्->पृछ्
पृतनाषह्->पृतनाषाह्
पृथुश्रोणि->पृथुश्रोणी
पृष्टि->पृष्ठि
पृष्टि->पृष्ठी
पृष्टिवह्->पृष्टिवाह्
पृष्टी->पृष्ठि
पृष्टी->पृष्ठी
पृष्ट्या->पृष्ठ्या
पृष्ठवह्->पृष्ठवाह्
पेट->पेठ
पेटक->पैठक
पेटाक->पैठक
पेरणि->पेरणी
पेश->पेस
पेशस्->पेसस्
पेषणि->पेषणी
पैङ्गि->पैङ्गी
पैटक->पैठक
पैटाक->पैठक
पोथकि->पोथकी
पौञ्जिष्ट->पौञ्जिष्ठ
पौण्ड्रमत्स्यक->पौण्ड्रमात्स्यक
पौरण्टक->पौरण्ठक
पौर्वदेहिक->पौर्वदैहिक
पौष्पि->पौष्पी
प्रक्वण->प्रक्वाण
प्रख्यस्->प्रख्यास्
प्रगे->प्रगै
प्रचलक->प्रचालक
प्रचलाक->प्रचालक
प्रजनु->प्रजनू
प्रजनुक->प्रजानुक
प्रजहित->प्रजाहित
प्रजापति->प्रजापती
प्रज्ञप्ति->प्रज्ञप्ती
प्रज्वलित->प्रज्वालित
प्रणय->प्रणाय
प्रणयन->प्रणयान
प्रतति->प्रतती
प्रतनु->प्रतनू
प्रतरम्->प्रतराम्
प्रतिकश->प्रतिकास
प्रतिकाश->प्रतिकास
प्रतिच्छदन->प्रतिच्छादन
प्रतिनदि->प्रतिनदी
प्रतिपत्नि->प्रतिपत्नी
प्रतिपथ->प्रतिपात
प्रतिपद->प्रतिपाद
प्रतिपालन->प्रतिफलन
प्रतिप्राश्->प्रतिप्रास्
प्रतिफल->प्रतिफाल
प्रतिभयकर->प्रतिभयाकार
प्रतिश्रोतस्->प्रतिस्रोतस्
प्रतिष्ठ->प्रतीष्ट
प्रतिष्ठ->प्रथिष्ट
प्रतिहरण->प्रतिहारण
प्रतिहार->प्रातिहर
प्रतिहारक->प्रातिहारक
प्रतीकाश->प्रतीकास
प्रतीपान->प्रातिपान
प्रतीवी->प्रथिवि
प्रतीहार->प्रातिहर
प्रत्यक्षता->प्रत्याक्षता
प्रत्यक्षदर्शन->प्रत्याक्षदर्शन
प्रत्यपर->प्रत्यापण
प्रत्यभिज्ञा->प्रत्याभिज्ञा
प्रत्ययनम्->प्रत्यायनम्
प्रत्ययितव्य->प्रत्यायितव्य
प्रत्यासर->प्रत्यासार
प्रथ->प्रात
प्रथस्->प्रातश्
प्रथस्->प्रातस्
प्रद->प्राध
प्रदा->प्रादा
प्रदाम्->प्रधम्
प्रदाय->प्रादाय
प्रदाव->प्रधाव
प्रदि->प्रदी
प्रदि->प्रादि
प्रदि->प्राधी
प्रदुह्->प्रादुः
प्रदेशिनी->प्रादेशिनी
प्रदोषक->प्रादोषक
प्रद्रुह्->प्रध्रुह्
प्रध->प्राध
प्रधा->प्रादा
प्रधि->प्रादि
प्रधि->प्राधी
प्रधी->प्रादि
प्रधी->प्राधी
प्रपादिक->प्रपादीक
प्रबल->प्रबाल
प्रबलवन्त्->प्रबालवन्त्
प्रबालिक->प्राबालिक
प्रबोध->प्रभोद
प्रबोध->प्राबोध
प्रबोधन->प्रभोदन
प्रभा->प्राबा
प्रमति->प्रमती
प्रमति->प्रमथि
प्रमति->प्रमाथी
प्रमदकानन->प्रमदाकानन
प्रमय->प्रमाय
प्रमित->प्रमीत
प्रमोद->प्रामोद
प्रमोदक->प्रामोदक
प्रयति->प्रयाति
प्रयस्->प्रायश्
प्रया->प्राया
प्रयुध्->प्रायुध्
प्ररुह्->प्रारुह्
प्रलम्ब->प्रालंब
प्रलम्बन->प्रालम्भन
प्रलम्भ->प्रालंब
प्रलम्भन->प्रालम्भन
प्रवणि->प्रवाणी
प्रवरकाण्ड->प्रवरखण्ड
प्रवह्लि->प्रवह्ली
प्रवाणि->प्रवाणी
प्रवाल->प्रावाल
प्रवृत्->प्रावृत्
प्रवेणि->प्रवेणी
प्रवेश्य->प्रावेश्य
प्रव्रजिका->प्रव्राजिका
प्रव्रजित->प्रव्राजित
प्रव्रज्य->प्रव्राज्य
प्रशम->प्रशाम
प्रशस्->प्रशास्
प्रशस्त->प्रशास्त
प्रशान्->प्रसन्
प्रशुश्रुक->प्रशुस्रुक
प्रष्टि->प्रष्ठी
प्रष्ठवह्->प्रष्ठवाह्
प्रस्->प्रास्
प्रसङ्ग->प्रसङ्घ
प्रसरणि->प्रसरणी
प्रसरणि->प्रसारणी
प्रसह्->प्रसाह्
प्रसह्->प्राशः
प्रसह्->प्रासः
प्रसाद्->प्रसाध्
प्रसादित->प्रसाधित
प्रसादिन्->प्रसाधिन्
प्रसाद्य->प्रसाध्य
प्रसाद्य->प्रासाद्य
प्रस्तरण->प्रास्तरण
प्रस्थ->प्रास्त
प्रहसित->प्रहासित
प्रहाणि->प्रहारि
प्रहुत->प्राहूत
प्रहेलि->प्रहेली
प्रह्ल->प्राह्ल
प्रह्लाद->प्राह्लाद
प्राक्कोशल->प्राक्कोसल
प्राक्फल्गुनी->प्राक्फाल्गुनी
प्राण्->प्रार्
प्राणधर->प्राणधार
प्राणधर->प्राणाधार
प्राणप्रिय->प्राणाप्रिय
प्राणाह->प्राराह
प्रातिपदिक->प्रातिपादिक
प्रातिपीय->प्रातीपीय
प्रातिपेय->प्रातीपेय
प्रान्तर->प्रान्तार
प्रायोपविष्ट->प्रायोपविष्ठ
प्राश्->प्रास्
प्राशित्रहरण->प्राशित्राहरण
प्रियक->प्रियाक
प्रियंकर->प्रियंकार
प्रियजन->प्रियाजन
प्रीति->प्रीती
प्रेण्->प्रेर्
प्रेणि->प्रेरी
प्रेप->प्रैप
प्रोक्षणि->प्रोक्षणी
प्रोद्दण्ड->प्रोद्दाण्ड
प्रोह्यपदि->प्रोह्यपादि
प्लक्षप्रस्रवण->प्लक्षप्रास्रवण
प्लाक्षि->प्लाक्षी
फट्->फाट्
फणि->फारि
फणि->फारी
फणी->फारि
फणी->फारी
फलकाङ्क्षिन्->फलाकाङ्क्षिन्
फलग्रहि->फलग्राही
फलचमस->फालचमस
फलय->फलाय
फलि->फालि
फलि->फाली
फलित->फालित
फली->फालि
फली->फाली
फलोदक->फलौदक
फल्गु->फल्गू
फल्गुनीभव->फाल्गुनीभव
फाणि->फारि
फाणि->फारी
फाल्गुनि->फाल्गुनी
फुत्कृत->फूत्कृत
फेनिल->फेनील
फेलि->फेली
बज->भज
बट्->बठ्
बद्->भद्
बद्धपृष्ट->बद्धपृष्ठ
बद्व->बध्व
बध्->भद्
बन्दि->बन्धि
बन्दी->बन्धि
बन्ध->भन्द
बन्धनीय->भन्दनीय
बन्धुर->बन्धूर
बबर->बभार
बबर->बाबर
बभ्रवी->बाभ्रवी
बम्भरालि->बम्भराली
बम्भरालि->बंभराली
बम्भारव->भम्भारव
बर्ब्->भर्भ्
बर्बर->बार्बर
बर्बरक->बार्बरक
बर्बरि->बर्बरी
बर्हस्->बार्हस्
बर्हिण->बार्हिण
बलज->बालज
बलदी->बलादि
बलदी->बलाधि
बलदी->बालधि
बलल->बलाल
बलस->बलाश
बलावस्थ->बालावस्थ
बलि->बालि
बलि->बाली
बलिक->बलीक
बलिक->बालिक
बलिन्->बालिन्
बलिमन्->बलिमान्
बलिवाक->बलीवाक
बलिहन्->बालिहन्
बली->बालि
बली->बाली
बल्लाल->भल्लाल
बव->बाव
बष्कयणी->बष्कयाणी
बह्->बाह्
बह्->भः
बह्->भाः
बहु->बाहू
बहुकण्टक->बाहुकण्टक
बहुकरणीय->बहुकारणीय
बहुत्र->बाहुत्र
बहुदासपुरुष->बहुदासपूरुष
बहुधार->बहूदर
बहुपद्->बहुपाद्
बहुपुत्र->बाहुपुत्र
बहुमल->बहुमाल
बहुमाय->बाहुमय
बहुली->बाहुलि
बहुवत्->बाहुवत्
बहुविद्य->बहुविध्य
बह्लि->बाह्लि
बाड्->भड्
बाणता->भरता
बाणवन्त्->भरवन्त्
बाध्->भद्
बाध->भद
बाधबुद्धिप्रतिबन्धकताविचार->बाधबुद्धिप्रतिभन्धकताविचार
बालकेलि->बालकेली
बालचर्य->बालाचार्य
बालतन्त्र->बालातन्त्र
बालरामायण->बालरामायाण
बालायनि->बालायनी
बास->भस
बाहु->बाहू
बाहूबाहवि->बाहूबाहावि
बिटक->बिठक
बिटक->बीटक
बिसाकर->बिसाकार
बुक्कन्->बूक्कन्
बुन्द->बुन्ध
बृहत्काश->बृहत्कास
बृहत्सर्वानुक्रमणी->बृहत्सार्वानुक्रमणी
बैन्दवि->बैन्दवी
बोधकर->बोधकार
ब्रध्नश्व->ब्रध्नाश्व
ब्रह्मकल्प->ब्राह्मकल्प
ब्रह्मदान->ब्रह्मधन
ब्रह्मदान->ब्रह्मधान
ब्रह्मन्->ब्राह्मन्
ब्रह्मनामावलि->ब्रह्मनामावली
ब्रह्मपथ->ब्रह्मपात
ब्रह्मपद->ब्रह्मपाद
ब्रह्मपृष्ट->ब्रह्मपृष्ठ
ब्रह्मबन्धु->ब्रह्मबन्धू
ब्रह्ममुहूर्त->ब्राह्ममुहूर्त
ब्रह्मयोनि->ब्रह्मयोनी
ब्रह्मविद्याभरण->ब्रह्मविद्याभारण
ब्रह्मवेदि->ब्रह्मवेदी
ब्रह्मसिद्धान्त->ब्राह्मसिद्धान्त
ब्रह्मस्व->ब्रह्मास्व
ब्रह्महुत->ब्राह्महुत
ब्रह्माणी->ब्राह्मणि
ब्रह्माद्रिजाता->ब्राह्माद्रिजाता
ब्रह्माधिगमिक->ब्रह्माधिगामिक
ब्रह्मानन्दसरस्वती->ब्रह्मानन्दसारस्वती
ब्रह्माहुत->ब्राह्महुत
ब्रह्माहुति->ब्रह्माहूति
ब्रह्मी->ब्राह्मी
ब्राह्मणता->ब्राह्मणाता
ब्राह्मि->ब्राह्मी
भक्ति->भक्ती
भक्ष्यालाबु->भक्ष्यालाबू
भगदा->भागधा
भगदेव->भगदैव
भगन->भागन
भगनन्दा->भगानन्दा
भगाधान->भागधान
भङ्गकर->भङ्गकार
भङ्गि->भङ्गी
भणति->भरति
भणति->भरती
भणन->भणान
भणनीय->भरनीय
भण्डर->भण्डार
भण्डि->भण्डी
भण्डिल->भण्डील
भद्रकार->भद्राकर
भद्रकार->भद्राकार
भद्रश्रिय->भद्रश्रीय
भम्भराव->भम्भारव
भरणि->भरणी
भर्तृदेवता->भर्तृदैवता
भर्ब्->भर्भ्
भवन्ति->भवन्ती
भवभाव->भवाभव
भवभाव->भवाभाव
भस्त्रफला->भस्त्राफला
भागदा->भागधा
भागवति->भागवती
भागुरि->भागुरी
भाण्डि->भाण्डी
भाण्डिक->भाण्डीक
भात्वक्षस्->भात्वक्षास्
भारय->भाराय
भारवह्->भारवाह्
भारवि->भारवी
भारहर->भारहार
भारि->भारी
भार्गि->भार्गी
भाल्लुक->भाल्लूक
भावयु->भावयू
भास्कर->भास्खर
भास्करेष्टा->भास्कारेष्टा
भिक्षुकीपराक->भिक्षुकीपारक
भिदा->भीदा
भीमाकर->भीमाकार
भीरु->भीरू
भुजज्या->भूजज्या
भुरिषह्->भूरिषह्
भुरिषह्->भूरिषाह्
भुशुण्डि->भुशुण्डी
भुषुण्डि->भुषुण्डी
भुसुक->भुसुख
भूजम्बु->भूजम्बू
भूतभव->भूतभाव
भूमिजम्बु->भूमिजम्बू
भूमिपति->भूमीपति
भूमिभुज्->भूमीभुज्
भूरि->भूरी
भूर्जकण्टक->भूर्जकण्ठक
भूर्भुव->भूर्भूव
भूवह्->भूवाह्
भृकुंश->भृकुंस
भृकुटि->भृकुटी
भृङ्गरिटि->भृङ्गरीटि
भृङ्गारि->भृङ्गारी
भृङ्गि->भृङ्गी
भृति->भृती
भृत्यभाव->भृत्याभाव
भृष्टि->भृष्टी
भेरि->भेरी
भैक्षक->भैक्षाक
भैक्षचरण->भैक्षाचरण
भैमि->भैमी
भोलि->भौलि
भौरिकि->भौरिकी
भौलिङ्गि->भौलिङ्गी
भ्रंश->भ्रंस
भ्रकुंश->भ्रकुंस
भ्रकुटि->भ्रकुटी
भ्रमरक->भ्रामरक
भ्रमि->भ्रमी
भ्रुकुंश->भ्रुकुंस
भ्रुकुंश->भ्रूकुंस
भ्रुकुटि->भ्रुकुटी
भ्रुकुटि->भ्रूकुटी
भ्रुकुटिबन्ध->भ्रूकुटीबन्ध
भ्रूकुंश->भ्रूकुंस
भ्रूकुटि->भ्रूकुटी
मक्कुल->मक्कूल
मघवन्->मघवान्
मचर्चिका->मचर्छिका
मञ्जि->मञ्जी
मञ्जु->मञ्जू
मटची->मठची
मणि->मणी
मणिरत->मणिरथ
मणिव->मणीव
मण्डलवट->मण्डलवाट
मण्डलिक->मण्डलीक
मत->मथ
मत्सगण्ट->मत्सगण्ठ
मत्स्याशन->मत्स्यासन
मदनपाल->मदनफल
मदि->मदी
मदिष्ठ->मधिष्ठ
मद्यपाशन->मद्यपासन
मधुकरिन्->मधुकारिन्
मधुपर्णि->मधुपर्णी
मधुमति->मधुमती
मधुयष्टि->मधुयष्टी
मधुलिका->मधूलिका
मध्यमवह्->मध्यमवाह्
मध्यमादि->मध्यमादी
मनःशिल->मनःसिल
मनन->मनान
मन्ति->मन्थि
मन्त्रार्थदीप->मन्त्रार्थादीप
मन्त्रार्थमञ्जरी->मन्त्रार्थामञ्जरी
मन्त्रि->मन्त्री
मन्दक->मन्दाक
मन्दन->मन्दान
मन्दोच्च->मन्दोच्छ
मरी->माणि
मरी->मारी
मरीचि->मरीची
मरीचि->मरीछि
मरीचि->मारीची
मरीचोपपुराण->मारीचोपपुराण
मरुत्पाल->मरुत्फल
मरुभू->मरूभू
मरुव->मरूव
मर्त->मार्त
मलवदेश->मालवदेश
मलवन्त्->मलावन्त्
मलाका->मालका
मलिनी->मालिनी
मल्लपुर->मल्लापुर
मल्लारि->मल्लारी
मशक->मशाक
मशककुटि->मशककुटी
मषम्->माषम्
मषि->माषि
मषी->माषि
मसूरि->मसूरी
मसूरि->मासुरि
मह->माह
महदाशा->महादशा
महन्->महान्
महन->महान
महाकपि->महाकापि
महाकर्णि->महाकर्णी
महाकुलीन->माहाकुलीन
महाजम्बु->महाजम्बू
महादान->महाधान
महादेवहत->महादेवाहत
महाद्वार->महाध्वर
महाधन->महाधान
महानन्दि->महानन्दी
महानाम्निक->माहानाम्निक
महापान->महाफन
महाप्रजापति->महाप्रजापती
महाप्रसाद->महाप्रासाद
महामञ्जुषक->महामञ्जूषक
महामण्डलिक->महामण्डलीक
महामति->महामती
महामयूरी->महामायूरी
महामूर्ति->माहामूर्ति
महायम->माहयाम
महायाम->माहयाम
महाविज्ञ->महावीज्य
महावीणा->महावीरा
महाव्रतिक->माहाव्रतिक
महाशफर->महासफर
महाशान्ति->महाशान्ती
महाशाल->महासाल
महिदास->महीदास
महिमन्->महिमान्
महिषि->महिषी
महीरत->महीरथ
महोदर->महोदार
महौषधि->महौषधी
मांसेपद्->मांसेपाद्
माटियारि->माटीयारि
माड->माढ
माण्डूकायनि->माण्डूकायनी
माण्डूकि->माण्डूकी
माति->माती
मातुलि->मातुली
मातृबन्धु->मातृबन्धू
माधवि->माधवी
माधुरि->माधुरी
माध्यंदिनि->माध्यंदिनी
मानस->मानास
मानसिक->मानसीक
मायूरि->मायूरी
मारहाटी->मारहाठी
मारि->मारी
मारीचि->मारीची
मारुति->मारुती
मार्गयथ->मार्गायात
मार्जारि->मार्जारी
मार्ष्टि->मार्ष्ठि
मालाधर->मालाधार
मालि->माली
मिघ्->मीग्
मिच्चक->मिच्छक
मित->मिथ
मित->मीत
मित्रक्रु->मित्रक्रू
मित्रमित्र->मित्रामित्र
मित्रशिस्->मित्रशीस्
मित्रिय->मित्रीय
मिशि->मिशी
मिशि->मिसी
मिश्र->मिस्र
मिश्रचोर->मिश्रचौर
मिसि->मिसी
मुका->मूका
मुकुली->मुखुली
मुक्ताप्रसू->मुक्ताप्रासू
मुक्तावलि->मुक्तावली
मुखदूषण->मूखदूषण
मुट्->मुठ्
मुट->मुठ
मुण्->मूर्
मुण्ट्->मूण्ठ्
मुण्ठ्->मूण्ठ्
मुथशिल->मुथशील
मुदकर->मुदाकर
मुदर->मुदार
मुद्गष्ट->मुद्गष्ठ
मुनि->मुनी
मुमुचान->मुमूचान
मुर्->मूर्
मुह्->मूः
मूर्ति->मूर्ती
मृगनाभि->मृगनाभी
मृच्->मृछ्
मृडानी->मृढानी
मृदु->मृधु
मृदू->मृधु
मेटि->मेटी
मेटि->मेठी
मेठि->मेठी
मेडि->मेढि
मेथि->मेथी
मेदिनि->मेदिनी
मेधि->मेधी
मेन->मैन
मेनाद->मैनाद
मेलन्दुक->मेलान्धुक
मैत्रायणि->मैत्रायणी
मैत्रि->मैत्री
मोघोलि->मोघोली
मोचि->मोची
मोण->मोर
मोदक->मोदाक
मोदाकि->मोदाकी
मोरट->मौरट
मोष->मौष
मौक्तिकावलि->मौक्तिकावली
मौखरि->मौखरी
मौजवत->मौजावत
मौलि->मौली
यजमानप्रयोग->याजमानप्रयोग
यज्ञसच्->यज्ञसाच्
यज्ञायज्ञिय->यज्ञायज्ञीय
यत->यथ
यति->यती
यत्कारणम्->यात्कारणम्
यत्र->यात्र
यत्संख्याक->यत्संख्याख
यथा->याता
यथा->याथा
यथाकाम्य->याथाकाम्य
यथातथ्यम्->याथातथ्यम्
यथाबलम्->यथाबालम्
यदि->यदी
यन्त्रप्रकाश->यन्त्रप्राकाश
यन्त्रशर->यन्त्रसार
यमकोटि->यमकोटी
यमघण्ट->यमघण्ठ
यमता->यामाता
यमानुग->यामानुग
यमुना->यामुना
ययावर->यायवर
ययि->ययी
यवकोटि->यवकोटी
यवनी->यवानी
यवनी->यावानी
यवाद्->यावद्
यश->यस
यष्टिक->यष्टीक
यष्टिक->याष्टिक
यहु->यहू
याजुर्वेदिक->याजुर्वैदिक
याज्ञसेनि->याज्ञसेनी
यामुनेष्टक->यामुनेष्ठक
युवखलति->युवखलती
युवति->युवती
यूनि->यूनी
योगरूढ->योगारूढ
योगि->योगी
योनि->योनी
योनिक->यौनिक
रक->रख
रक्तपदी->रक्तपादी
रक्तराजि->रक्तराजी
रक्ताक्षि->रक्ताक्षी
रक्तातिसार->रक्तातीसार
रक्षि->रक्षी
रघुयन्त्->रघूयन्त्
रङ्गजीवक->रङ्गाजीवक
रज्जु->रज्जू
रतज्वर->रथज्वर
रति->रती
रतोद्वह->रतोद्वाह
रथकर->रथाकार
रथकार->रथाकार
रथतुर्->रथतूर्
रथाङ्गपाणि->रथाङ्गपाणी
रथान्तर->राथन्तर
रथीतर->राथितर
रद->रध
रद्द->रद्ध
रमण->रमाण
रमापति->रामपति
रम्ब्->रंभ्
रयस्->रायस्
रयिषच्->रयिषाच्
रयिषह्->रयिषाह्
रराट्य->रराठ्य
रवण->रवाण
रवत->रावत
रवथ->रावत
रविकुलदीपप्रकाश->रविकुलदीपप्रकास
रविलोह->रविलौह
रस->राश
रसमञ्जरी->रासमञ्जरी
रसवह->रसावह
रह्->राः
रह->राह
रहःशील->रहःसील
रहसनन्दिन्->रहसानन्दिन्
राग->राघ
रागषाडव->रागषाढव
राजदार->राजाधर
राजधानी->राजादनी
राजन->राजान
राजनि->राजनी
राजशफर->राजसफर
राजशुक->राजशूक
राजावलि->राजावली
राणक->राणाक
राणि->राणी
रात->राथ
रात्रिचर->रात्रिचार
रात्रिमणि->रात्रिमाणि
राधि->राधी
रामकिरी->रामकीरी
रामधर->रामाधार
रामविज्ञापनस्तोत्र->रामविज्ञापनास्तोत्र
रामि->रामी
रायण->रायाण
रावणि->रावणी
राहुग्रह->राहुग्राह
रिक्तहार->रिक्थहर
रिक्तहार->रिक्थहार
रिक्ती->रिक्थी
रु->रू
रुंश्->रुंस्
रुक्मलोह->रुक्मलौह
रुक्मि->रुक्मी
रुचिरञ्जन->रुचिराञ्जन
रुद्रगायत्रि->रुद्रगायत्री
रुप्->रूप्
रुम->रूम
रूपशस्->रूपसस्
रेत्य->रैत्य
रेवति->रेवती
रेवति->रैवती
रोचस्->रौचस्
रोचि->रोची
रोट->रौट
रोड्->रौड्
रोड->रौड
रोमन्थ->रोमान्त
रोमराजि->रोमराजी
रोहक्षिति->रौहक्षिति
रोहित->रौहीत
रौद्रि->रौद्री
रौहिणिक->रौहिणीक
रौहित->रौहीत
लक->लख
लक->लाख
लकुल->लाकुल
लक्षणवाद->लक्षणावाद
लग्->लघ्
लघुच्छेद्य->लघूच्छेद्य
लछ्->लाच्
लट्->लाट्
लट्य्->लाठ्य्
लब्धनामन्->लब्धानामन्
लम्बोष्ठ->लम्बौष्ठ
ललित->ललिथ
ललित->लालित
ललितिक->ललीतिक
लवणसिन्धु->लावणसिन्धु
लवलि->लावली
लवली->लावली
लसीका->लासिका
लहरि->लहरी
लाङ्गलि->लाङ्गली
लाङ्गुलिनी->लाङ्गूलिनी
लाबु->लाबू
लालाटि->लालाटी
लावेरिणि->लावेरिणी
लिगु->लिघु
लिङ्->लीङ्
लिङ्गधारणचन्द्रिका->लिङ्गधारणाचन्द्रिका
लिपि->लिपी
लिह्->लीः
लुप्->लूप्
लुब्धता->लुब्धाता
लुम्बिनि->लुम्बिनी
लुश->लुस
लेखनि->लेखनी
लेशिक->लेसिक
लेशिक->लैशिक
लोटिका->लोठिका
लोमकिन्->लोमाकिन्
लोमशातन->लोमसातन
लोहर->लोहार
लोहि->लोही
लोहितक->लौहितक
लोहितध्वज->लौहितध्वज
लोहितायनि->लोहितायनी
लोहिताश्व->लौहितास्व
लौहिताश्व->लौहितास्व
वंशिवाद्य->वंशीवाद्य
वक्->वाक्
वक्ष्->वाक्ष्
वक्षी->वाक्षि
वख्->वाक्
वङ्ग्->वङ्घ्
वङ्ग्->वाङ्घ्
वङ्घ->वन्ग
वच्->वाछ्
वच->वाछ
वचनकर->वचनकार
वचस->वाचस
वचसांपति->वाचसाम्पति
वचाचार्य->वछाचार्य
वचि->वाछि
वच्छ->वाच्छ
वज्रवह्->वज्रवाह्
वज्रशुचि->वज्रसूची
वज्रसूचि->वज्रसूची
वञ्चक->वाञ्छक
वञ्चन->वाञ्छन
वञ्चनीय->वाञ्छनीय
वञ्चिन्->वाञ्छिन्
वञ्चुक->वञ्चूक
वञ्च्य->वाञ्छ्य
वट->वठ
वटकणिका->वटकणीका
वटि->वटी
वटि->वठि
वटि->वाटि
वटि->वाटी
वट्टदेव->वाट्टदेव
वट्य->वाठ्य
वडबानल->वाडबानल
वडभि->वडभी
वतरणी->वातारणि
वतायन->वातयान
वत्सप्रि->वत्सप्री
वद्->वाध्
वद->वाध
वदक->वाधक
वदन->वाधन
वदावद->वधावध
वदि->वधी
वदि->वादि
वदि->वादी
वदितर्->वादितर्
वध्->वाध्
वध->वाध
वधक->वाधक
वधा->वाधा
वधिक->वाधिक
वधु->वाधु
वधु->वाधू
वधू->वाधु
वधू->वाधू
वध्रश्व->वध्रस्व
वध्रि->वध्री
वध्रि->वाध्री
वन्->वाङ्
वन्->वान्
वनचर्य->वनाचार्य
वनमक्षिका->वनमाक्षिका
वनराजि->वनराजी
वनवास->वनावास
वनस->वनाश
वनि->वनी
वनोद्देश->वनोद्देस
वन्ति->वान्ती
वन्य->वान्य
वप्पिय->वप्पीय
वप्रि->वप्री
वमि->वमी
वयुन->वायुन
वरण->वरर
वरणक->वारणक
वरणसी->वराणसी
वरणसी->वारणसी
वरणसी->वारणासी
वरणाशी->वराणसी
वरणाशी->वारणसी
वरणाशी->वारणासी
वरतनु->वरतनू
वरदान->वरधान
वरयुवति->वरयुवती
वरवरण->वरवारण
वरसान->वाणासन
वरसुन्दरी->वारसुन्दरी
वराङ्गना->वाराङ्गना
वरारक->वारणक
वराशि->वरासी
वरासन->वाणासन
वरासि->वरासी
वराहकन्द->वाराहकन्द
वराहपर्वत->वाराहपर्वत
वराहसंहिता->वाराहसंहिता
वराहाश्व->वाराहाश्व
वरिमत्->वारिमत्
वरुक->वारुक
वरुण्य->वारुण्य
वरूक->वारुक
वरूत्रि->वरूत्री
वरेण->वारेण
वर्ग->वर्घ
वर्चोदा->वर्चोधा
वर्णतूलि->वर्णतूली
वर्त->वार्त
वर्तनि->वर्तनी
वर्तिका->वार्तिका
वर्त्र->वार्त्र
वर्धकि->वर्धकी
वर्मिक->वार्मिक
वर्वर->वार्वर
वर्वरक->वार्वरक
वर्श्मन्->वर्स्मन्
वर्ष्->वार्ष्
वर्षकरी->वर्षकारी
वर्षवसन->वर्षावसान
वर्षाम्भःपारणव्रत->वर्षाम्भःपारणाव्रत
वलक->वलाक
वलक->वालाक
वलन->वलान
वल्लर->वल्लार
वल्लरि->वल्लरी
वल्लिशूरण->वल्लिसूरण
वशन->वसान
वशाढ्यक->वसाढ्यक
वशाति->वसती
वशि->वसी
वशी->वसी
वसति->वसती
वसन->वसान
वसावि->वसावी
वसि->वसी
वसुदेवत->वसुदैवत
वस्ति->वस्ती
वस्वोकसारा->वस्वौकसारा
वह्->वाः
वाक्केलि->वाक्केली
वागुजि->वागुजी
वागुण->वागुर
वागुलि->वागुली
वाच्->वाछ्
वाच->वाछ
वाचनिक->वाचनीक
वाचाट->वाचाठ
वाची->वाछि
वाजश्रवस्->वाजस्रवस्
वाञ्चेश्वर->वाञ्छेश्वर
वाट्य->वाठ्य
वाणकि->वारकि
वाणकि->वारकी
वाणरसी->वारणसी
वाणरसी->वारणासी
वाणारसी->वारणसी
वाणारसी->वारणासी
वाणिभूषण->वाणीभूषण
वातकि->वातकी
वातय्->वाताय्
वातहत->वाताहत
वातहर->वाताहार
वातुलि->वातूली
वात्सि->वात्सी
वाद->वाध
वादक->वाधक
वादन->वाधन
वादिक->वाधिक
वाधुक्य->वाधूक्य
वान्ति->वान्ती
वामोरु->वामोरू
वारणबुसा->वारणबूसा
वारवाणि->वारवाणी
वारुणि->वारुणी
वालक->वालाक
वालुका->वालूका
वालुकि->वालुकी
वाशिता->वासिता
वासवि->वासवी
वासुकि->वासुकी
वाहस्->वाहास्
विंशतिम->विंसतिम
विकुर्वण->विकुर्वाण
विकृति->विकृती
विक्रयिक->विक्रायिक
विगम->विगाम
विगाथा->विघाता
विचय->विछाय
विचि->विची
विजयपाल->विजयफल
विज्ञप्ति->विज्ञाप्ति
विञ्जमर->विञ्जामर
विट->विठ
विडोजस्->विडौजस्
वितत्य->वितथ्य
वित्तनाथ->वित्तानाथ
विदाय->विधाय
विदारि->विदारी
विदि->विधी
विदु->विधू
विद्र->विध्र
विद्वंस्->विध्वंस्
विद्वन्->विद्वान्
विधव्->विधाव्
विधि->विधी
विधु->विधू
विनिवारण->विनीवरण
विन्ध्यावलि->विन्ध्यावली
विपणि->विपरी
विपणी->विपरी
विपदी->विपादी
विपलाश->विफलाश
विपुलस्रवा->विपुलाश्रवा
विपृष्ट->विपृष्ठ
विप्लविन्->विप्लाविन्
विभज->विभाज
विभ्रष्टेष्टिप्रयोग->विभ्राष्टेष्टिप्रयोग
विमनस्->विमानस्
वियोनि->वियोनी
विरजस्->विरजास्
विरजस->विराजस
विरथ->विरात
विरल->विराल
विरुदावलि->विरुदावली
विरेपस्->विरेफस्
विलय->विलाय
विलोटन->विलोठन
विवस्->विवास्
विवस्वन्->विवस्वान्
विवेकचूडामणि->विवेकचूडामणी
विशब्द->विशब्ध
विशिका->विशिखा
विशुण्डि->विशुण्डी
विश्रमण->विश्रामण
विश्रवण->विश्रावण
विश्रुति->विश्रुती
विश्वकद्रु->विश्वकद्रू
विश्वचर्षणि->विश्वचर्षणी
विश्वध->विस्वाद
विश्वधर->विस्वधार
विश्वधार->विस्वधार
विश्वशंभु->विश्वशम्भू
विश्वसामन्->विश्वासामन्
विश्वसृज्->विस्वसृज्
विश्वस्फटिक->विश्वस्फाटिक
विश्वाची->विस्वची
विश्वाधार->विस्वधार
विष्->वीष्
विषणि->विषाणी
विषधर->विषधार
विषमचतुरश्र->विषमचतुरस्र
विषमय->विषमाय
विषय->विषाय
विषित->वीषित
विषु->विषू
विष्कम्भिन्->विष्कांभिन्
विष्टि->विष्टी
विष्णुपद->विष्णुपाद
विष्वञ्च्->विष्वाञ्च्
विसुत->विसूत
विस्मयिन्->विस्मायिन्
विहर->विहाण
विहर->वीहार
विहार->वीहार
वीचि->वीची
वीणा->वीरा
वीणिन्->वीरिन्
वृजि->वृजी
वृत्तरत्नावलि->वृत्तरत्नावली
वृषण->वृषाण
वृषय->वृषाय
वृषवाह->वृषावाह
वृषागिर्->वृषागीर्
वृष्टि->वृष्टी
वृष्णि->वृष्णी
वेङ्कटभेट्->वेङ्कटभैट्
वेङ्गि->वेङ्गी
वेट->वेठ
वेणि->वेरि
वेणि->वैणि
वेणिक->वैरिक
वेणिमाधव->वेणीमाधव
वेणी->वेरि
वेणी->वैणि
वेणुवीणाधरा->वेणुवीणाधारा
वेत->वेथ
वेतण्ड->वैतण्ड
वेतालपञ्चविंशति->वेतालपञ्चविंशती
वेत्र->वैत्र
वेत्रकीय->वैत्रकीय
वेदत्व->वैधत्व
वेददीप->वेदाधिप
वेदनीय->वेधनीय
वेदमुख्या->वेधमुख्या
वेदविचार->वेधविचार
वेदशिरस्->वेदाशिरस्
वेदसिनी->वैदसिनी
वेदि->वेधी
वेदि->वैदी
वेदिक->वेदीक
वेदिक->वैधिक
वेदिश्रोणि->वेदिश्रोणी
वेदी->वेधी
वेदी->वैदी
वेद्या->वेध्या
वेद्या->वैद्या
वेश->वेस
वेश->वैश
वेशक->वैसाख
वेशवार->वैशवण
वेश्यात्व->वैश्यत्व
वेषश्रि->वेषश्री
वेष्क->वैष्क
वेसवार->वैशवण
वैखानसि->वैखानसी
वैणिक->वैरिक
वैतरणि->वैतरणी
वैदर्भि->वैदर्भी
वैदर्व्य->वैदार्व्य
वैदि->वैदी
वैदिक->वैधिक
वैदेहि->वैदेही
वैयल्कश->वैयल्कस
वैरकरण->वैरकारण
वैराटि->वैराटी
वैराट्या->वैराठ्या
वैरिणि->वैरिणी
वैशली->वैशाली
वैशाख->वैसाख
वैशालि->वैशाली
वैशिष्ट्य->वैशिष्ठ्य
वैश्वामित्रि->वैश्वामित्री
वैष्टपुरेय->वैष्ठपुरेय
वैहति->वैहती
वोड्र->वौड्र
व्यग्रत्व->व्याघ्रत्व
व्यति->व्यती
व्यभिमान->व्यभीमान
व्याघ्रपद्->व्याघ्रपाद्
व्यापृत->व्यापृथ
व्युत->व्यूत
व्रतति->व्रतती
व्रतपति->व्रातपती
व्रातपति->व्रातपती
व्रीहि->व्रीही
शकटायन->शाकटयन
शकटि->शकटी
शकटिका->शाकटिका
शकुनि->शकुनी
शकुल->शाकुल
शक्ति->शक्ती
शक्राग्नि->शक्राग्नी
शक्रि->शाक्री
शङ्क->शाङ्क
शंकर->शंखण
शंकरीय->शांकरीय
शङ्का->शङ्खा
शङ्कुचि->शाङ्कुची
शङ्ख->शाङ्क
शङ्खण->शाङ्कर
शङ्खनाभि->शङ्खनाभी
शङ्खिक->शाङ्किक
शट्->शठ्
शटि->शटी
शटि->शठी
शटि->शाटी
शण्->शार्
शणपर्णी->शरपर्णी
शण्डामर्क->शण्ढामर्क
शतकाण्ड->शतखाण्ड
शतखण्ड->शतखाण्ड
शतद्रुति->शतद्रुती
शतपद्->शतपाद्
शतमख->शातमख
शतवार->शतावर
शनक->शानक
शनकावलि->शनकावली
शनि->शानी
शफरि->शफरी
शबरभाष्य->शाबरभाष्य
शब्दित->शाब्दित
शम->शाम
शम्बर->शंभर
शम्बर->शम्भर
शम्बर->शाम्भर
शम्बु->शम्बू
शम्बु->शम्भु
शम्बु->शम्भू
शम्बु->शांबु
शंभव->शाम्बव
शंभव->शाम्भव
शंभु->शम्भू
शंभु->शांबु
शंभुनाथ->शम्भूनाथ
शंभू->शांबु
शयन->शयान
शयित->शायित
शर्->शार्
शरक्षेप->शराक्षेप
शरणि->शरारी
शरणी->शरारी
शरता->शारता
शरत्व->शारत्व
शरधान->शरादान
शरधि->शारदी
शरारि->शरारी
शरालि->शराली
शरि->शाणी
शरि->शारी
शरी->शाणी
शरी->शारी
शरेषीका->शरैषीका
शर्याति->शार्याति
शर्वरीक->शार्वरीक
शर्वाणी->शार्वरी
शल्मलि->शल्मली
शल्मलि->शाल्मली
शल्लकि->शल्लकी
शशक->शाशक
शशबिन्दु->शाशबिन्दु
शशाण्डुलि->शशाण्डुली
शशादन->शाशदान
शशी->शसि
शष्कुलि->शष्कुली
शसा->शासा
शस्त्रघात->शास्त्रगत
शस्त्रवन्त्->शास्त्रवन्त्
शाकपूणि->शाखापुरी
शाकरी->शाकारी
शाकी->शाखी
शाखि->शाखी
शांकरि->शांकरी
शाटि->शाटी
शाट्यायनि->शाट्यायनी
शाट्यायनि->शाठ्यायनि
शाठ्यवन्त्->शाठ्यावन्त्
शाणि->शाणी
शाणि->शारी
शानि->शानी
शान्तिकर->शान्तिकार
शापटिक->शापठिक
शापनाशन->शापनासन
शाबरि->शाबरी
शाबस्ति->शाबस्ती
शाम्बर->शाम्भर
शाम्बवानन्दकल्प->शांभवानन्दकल्प
शाम्बव्य->शाम्भव्य
शारि->शारी
शार्ङ्गष्टा->शार्ङ्गष्ठा
शार्वरिक->शार्वरीक
शालङ्क->शालाङ्क
शालि->शाली
शालिपिण्ड->शालिपीण्ड
शालिपिष्ट->शालिपिष्ठ
शाल्मलि->शाल्मली
शास्त्रचारण->शास्त्राचरण
शिक्षण->शिक्षाण
शिख->शीक
शिङ्गभट्ट->शिङ्गाभट्ट
शिङ्गि->शिङ्गी
शितिपद्->शितिपाद्
शिपविष्ट->शिपविष्ठ
शिम्बि->शिम्बी
शिम्बि->शिंबी
शिलाभव->शिलाभाव
शिवप्रिय->शिवाप्रिय
शिवरात्रि->शिवरात्री
शिवस्कन्द->शिवस्कन्ध
शिशय->शिशाय
शिशुक->शिसुक
शीघ्रिय->शीघ्रीय
शीतपर्णि->शीतपर्णी
शीतलय्->शीतलाय्
शीरि->शीरी
शुकनशा->शुकनाशा
शुकनशा->शुकनासा
शुकनसा->शुकनाशा
शुकनसा->शुकनासा
शुकपिण्डि->शुकपिण्डी
शुकपिण्डि->शूकपिण्डी
शुचिश्रवस्->शुचिस्रवस्
शुण्ठि->शुण्ठी
शुतुद्रि->शुतुद्री
शुद्धोदन->शुद्धौदन
शुनःशेप->शुनःशेफ
शुन्ध्यु->शुन्ध्यू
शुम्भन->शुम्भान
शुष्मिण->शुष्मीण
शूकपिण्डि->शूकपिण्डी
शूकापुट्ट->शूकापूट्ट
शूलि->शूली
शृङ्गि->शृङ्गी
शृधु->शृधू
शेफालि->शेफाली
शेवलिनी->शैवलिनी
शेवलिनी->शैवालिनी
शेवलिय->शैवालीय
शेवार->शैवर
शेवाली->शैवलि
शैक्य->शैख्य
शैबल->शैबाल
शैलालि->शैलाली
शैवि->शैवी
शैषिरि->शैषिरी
शोण->शौर
शौण्डि->शौण्डी
शौनःशेप->शौनःशेफ
शौनकि->शौनकी
शौवदंष्ट्र->शौवादंष्ट्र
श्च्युत्->श्च्युथ्
श्येनाश्वश्येन->श्येनाश्वश्यैन
श्रथ->श्रात
श्रद्धाप्रकरण->श्राद्धप्रकरण
श्रवणद्वादशी->श्रावणद्वादशी
श्रवणमाहात्म्य->श्रावणमाहात्म्य
श्रवणाकर्मन्->श्रावणकर्मन्
श्रवणिकाव्रत->श्रावणिकाव्रत
श्रवणी->श्रावणी
श्रविष्ठीय->श्राविष्ठीय
श्रिति->श्रिती
श्रियध्यै->श्रीयध्यै
श्रियावासिन्->श्रीयावासिन्
श्रीकर->श्रीकार
श्रीपर्णि->श्रीपर्णी
श्रीवह->श्रीवाह
श्रुतकीर्ति->श्रुतकीर्ती
श्रुति->श्रुती
श्रुष्टि->श्रुष्टी
श्रेण्य->श्रैण्य
श्रोणि->श्रोणी
श्रोत्रिय->श्रोत्रीय
श्वदंष्ट्रा->श्वादंष्ट्रा
श्वनी->श्वानी
श्वयीचि->श्वयीची
श्वसन->श्वसान
श्वसनाशन->श्वसनासन
श्वसित->श्वासित
श्वेत->श्वैत
श्वेततर->श्वेततार
श्वेतवह्->श्वेतवाः
श्वेतवह्->श्वेतवाह्
श्वेत्र->श्वैत्र
षट्पञ्चाशतिकहोरा->षट्पञ्चाशतिकाहोरा
षट्पद्->षट्पाद्
षडंश->षडंस
षडश्र->षडस्र
षड्ग्रन्थि->षड्ग्रन्थी
षण्ड->षाण्ड
षण्ढ->षाण्ड
षण्मुख->षाण्मुख
षष्टि->षष्टी
षष्टि->षष्ठी
षष्टिक->षाष्टीक
षष्टिमत्त->षष्ठिमत्त
षष्टिहायन->षष्ठिहायन
षष्टिह्रद->षष्ठीह्रद
षाष्टिक->षाष्टीक
षोडशनित्यतन्त्र->षोडशनित्यातन्त्र
षोडशसहस्र->षोडशसाहस्र
ष्ठि->ष्ठी
ष्ठिव्->ष्ठीव्
संयत->संयात
संयाति->संयाती
संवत्->संवात्
संवसन->संवसान
संश्रवण->संश्रावण
संसद्->संसाध्
संसारतरणि->संसारतरणी
संसृष्टि->संसृष्टी
संस्पर्शन->संस्पर्शान
संहर्षिन्->संहार्षिन्
सकल->सकाल
सकाकोल->सकाकौल
सक्ति->सक्थि
सक्ति->सक्थी
संकरिन्->संकारिन्
संख्यक->संख्याक
सङ्ग->सङ्घ
सङ्गट->सङ्घट
सङ्गट->सङ्घाट
संगीति->संगीती
संघटक->संघाटक
संघाटि->संघाटी
सचन->सचान
सचि->सची
संचल->संचाल
संजवन->संजावन
संजिति->संजीति
संज्ञपन->संज्ञापन
सट->सठ
सत्कृति->सत्कृती
सत्त्रशाला->सत्त्रसाला
सत्यशवस्->सत्यसवस्
सत्रासह->सत्रासाह
सधमद्->सधमाद्
सनता->सनाथा
सनय->सनाय
संतति->संतती
संतरम्->संतराम्
संदानिका->संधानिका
संदाय->संधय
संदाव->संधाव
संदिह्->संधिः
सन्दी->सन्धि
संधनजित्->संधनाजित्
सन्नद->सन्नाद
संनिनद->संनिनाद
सपण->सफर
सपर->सफर
सप्ततितम->सप्तातितम
सप्तभङ्गिनय->सप्तभङ्गीनय
सप्तशफ->सप्तसफ
सभाचर->सभाचार
सभापति->सभापती
सभिक->सभीक
समचतुरश्र->समचतुरस्र
समदु->समाधू
समधा->समादा
समधृत->समादृत
समनीक->समानीक
समभाग->समाभाग
समयकार->समयाकार
समया->समाया
समर->समाण
समरण->समराण
समरण->समारण
समरत->समारत
समरथ->समारत
समवर्तिन्->समावर्तिन्
समवस्रव->समवस्राव
समवहार->समवाहार
समवृत्त->समावृत्त
समस्->समास्
समाप्लव->समाप्लाव
समासङ्ग->समासाङ्ग
समिन्धन->समिन्धान
समिष्->समीष्
समीप->सामीप
समुच्छ्वसित->समुच्छ्वासित
समुद्ररशन->समुद्ररसन
समुद्रिय->समुद्रीय
समुन्नस->समुन्नास
समूर->सामूर
संपद->सम्पाद
संपद->साम्पद
संपदिन्->सम्पादिन्
संपर->सम्पार
संपराय->साम्पराय
संपवन->सम्पावन
संपाट->सम्पाठ
संपाद->साम्पद
संप्रति->सम्प्रती
संप्रति->संप्रती
संप्रदान->सम्प्रधान
संप्रेष->सम्प्रैष
संफल->सम्फाल
संबन्धि->सम्बन्धी
सम्बल->सम्भल
सम्बल->संभाल
संबलन->संभालन
संभर->सम्भार
संभल->संभाल
संभवन->सम्भावन
संभविन्->सम्भाविन्
संभव्य->सम्भाव्य
संभु->सम्भू
संभु->संभू
संभूति->सम्भूती
संमद->सम्माद
सरङ्ग->सराङ्घ
सरट->सराट
सरण्यु->सरण्यू
सरयु->सरयू
सरल->सराल
सरि->सरी
सर्जि->सर्जी
सर्वतनु->सर्वतनू
सर्वधर->सर्वधार
सर्वपुरुष->सर्वपूरुष
सर्वभयंकर->सर्वाभयंकर
सर्वयोनि->सर्वयोनी
सर्वसंभव->सर्वासम्भव
सर्वौषधि->सर्वौषधी
सवर->सवाण
सविकाश->सविकास
सवितृदेवत->सवितृदैवत
सशङ्क->सशङ्ख
सशल्क->सशाल्क
सहदेवि->सहदेवी
सहपुरुष->सहपूरुष
सहस्य->सहास्य
सहस्रघ्नि->सहस्रघ्नी
सहस्रनिर्णिज्->सहस्रानिर्णिज्
सहस्रपद्->सहस्रपाद्
सहस्रमुष्क->सहस्रमूष्क
सहस्रश्रुति->सहस्रस्रुति
सहूति->सहूती
सांस्रविण->सांस्राविण
साक्षिभूत->साक्षीभूत
सांकुचि->सांकुची
सांकृति->सांकृती
सातिलक->सातीलक
सादि->सादी
सानसि->सानसी
सामन->सामान
सामान्यलक्षणव्यभिचार->सामान्यलक्षणाव्यभिचार
सामुद्रि->सामुद्री
सायण->सायर
सारणि->सारणी
सारमिति->सारमीति
सारलोह->सारलौह
सारस->सारास
सारिष्ट->सारिष्ठ
सार्वरोगिक->सार्वरौगिक
सार्ववर्णिक->सार्ववार्णिक
सार्वसेनि->सार्वसेनी
सार्ष्टि->सार्ष्ठि
सालाकरी->सालाकारी
सावित्रि->सावित्री
सित->सीत
सितपट->सीतापट
सिन्धुरद्वेषिन्->सिन्धुरद्वैषिन्
सिन्धुराज->सिन्धूराज
सिरी->सीरि
सिरी->सीरी
सीतालोष्ट->सीतालोष्ठ
सुकर->सूकार
सुकष्ट->सुकाष्ठ
सुकान्त->सुखान्त
सुकाशन->सुखाशन
सुकृति->सुकृती
सुकेत->सुखेत
सुकेशि->सुकेशी
सुखकर->सुखकार
सुखवत्->सुखावत्
सुखस्पर्श->सुखास्पर्श
सुगन्धार->सुगान्धार
सुगन्धि->सुगन्धी
सुत्->सूत्
सुतत्व->सूतत्व
सुतनय->सूतनय
सुतनु->सुतनू
सुतप->सुताप
सुतपस्->सूतपस्
सुतसुत->सूतसुत
सुतात्मज->सूतात्मज
सुतार्णव->सूतार्णव
सुतासुत->सूतसुत
सुति->सूती
सुती->सूती
सुदत्त->सूदत्त
सुदन्त->सूदन्त
सुदशन->सुधाशन
सुदान्त->सूदन्त
सुदाम->सुधाम
सुदामन्->सूदामन्
सुदामन->सुधामान
सुदाय->सुधय
सुदि->सूदी
सुदिह्->सुधीः
सुदीदिति->सुदीदीति
सुदूर->सुधुर
सुदेवि->सुदेवी
सुधामन्->सूदामन्
सुधि->सूदी
सुधित->सूदित
सुधी->सूदी
सुनयक->सुनायक
सुनु->सूनू
सुनू->सूनू
सुपद्->सुपाद्
सुपर्वण->सुपर्वाण
सुपर्वन्->सुपर्वान्
सुप्रतिकर->सुप्रतीकार
सुभ्रु->सुभ्रू
सुभ्रुनासाक्षिकेशान्त->सुभ्रूनासाक्षिकेशान्त
सुमहामनस्->सुमाहामनस्
सुमालि->सुमाली
सुमित्रभू->सुमित्राभू
सुम्नयु->सुम्नायु
सुयशा->सुयाशा
सुर्->सूर्
सुरगृह->सुरागृह
सुरजा->सुराजा
सुरता->सुरथा
सुरता->सूरता
सुरदुन्दुभि->सुरदुन्दुभी
सुरनन्दा->सुरानन्दा
सुरप्रिय->सुराप्रिय
सुरभिष्टम->सुरभिष्ठम
सुरभिसमय->सुरभीसमय
सुरभिस्रवा->सुरभीस्रवा
सुरसाष्ट->सुरसाष्ठ
सुरसिन्धु->सुरासिन्धु
सुरसुत->सूरसुत
सुराजि->सूरजी
सुरापगा->सूरापगा
सुरि->सुरी
सुरुचि->सुरुची
सुवर्->सुवार्
सुवर्णष्ठीवि->सुवर्णष्ठीवी
सुवल्लि->सुवल्ली
सुविक्रान्तविक्रमिन्->सुविक्रान्तविक्रामिन्
सुशंस->सुसांस
सुशक्ति->सुसक्थि
सुशमि->सुशमी
सुशिख->सुशीक
सुशिप्र->सुसिप्र
सुशेरु->सुसेरु
सुश्रोणि->सुश्रोणी
सुह्->सूः
सुहव->सूहव
सूकर->सूकार
सूक्तवाक->सूक्तावाक
सूक्तिमुक्तावलि->सूक्तिमुक्तावली
सूति->सूती
सूदि->सूदी
सूनु->सूनू
सून्मद->सून्माद
सूर्मि->सूर्मी
सूर्यलोक->सूर्यालोक
सूर्यसुत->सूर्यसूत
सृजन->सृजान
सृणि->सृणी
सृणिक->सृणीक
सृप->सृफ
से->सै
सेनजित्->सेनाजित्
सैरि->सैरी
सोदय->सौधाय
सोपर->सोपार
सोभरि->सोभरी
सोभरि->सौभरी
सोमदेवत->सोमदैवत
सोमप->सोमाप
सोमपद->सोमपाद
सोमपीति->सोमपीती
सोमवन्त्->सोमावन्त्
सोमापि->सौमापि
सोमाश्रयायण->सोमाश्रायायण
सोमी->सौमि
सोहञ्जि->सोहाञ्जि
सौत्रामणि->सौत्रामणी
सौभरि->सौभरी
सौरमस->सौरमास
सौरि->सौरी
सौवर्णबलज->सौवर्णबालज
स्कम्भनि->स्कम्भनी
स्तन->स्थन
स्तनभव->स्थानाभाव
स्तनान्तर->स्थानान्तर
स्तम्बघात->स्तम्भगत
स्तम्बिन्->स्तंभिन्
स्तम्बेरम->स्ताम्बेरम
स्तव->स्थव
स्तवन->स्तवान
स्ताघ->स्थाघ
स्ताव->स्थव
स्तिमित->स्तीमित
स्तु->स्थू
स्तुति->स्तुती
स्तुतिशस्त्र->स्तुतिशास्त्र
स्तू->स्थू
स्तूणाकर्ण->स्थुणाकर्ण
स्तेय->स्थैय
स्तोत्रिय->स्तोत्रीय
स्त्रीकटि->स्त्रीकटी
स्त्रीवश->स्त्रीवास
स्त्र्यभिगमन->स्त्र्याभिगमन
स्थग->स्थाघ
स्थपनी->स्थापनी
स्थली->स्थालि
स्थली->स्थाली
स्थाग->स्थाघ
स्थाणुच्छेद->स्थाणूच्छेद
स्थापत्य->स्थापथ्य
स्थिति->स्थिती
स्थु->स्थू
स्थुरिका->स्थूणिका
स्थूरि->स्थूरी
स्थूलकाष्ठदह्->स्थूलकाष्ठधह्
स्थूलशाटि->स्थूलशाटी
स्थेय->स्थैय
स्निहिति->स्नीहिती
स्नीहिति->स्नीहिती
स्नेहिति->स्नेहिती
स्पर्शन->स्पर्शान
स्पिज्->स्फिज्
स्पृशि->स्पृशी
स्फटिक->स्फाटीक
स्फटिकारि->स्फटिकारी
स्फल्->स्फाल्
स्फाटिक->स्फाटीक
स्मद्रातिषच्->स्मद्रातिषाच्
स्मरारि->स्मारणी
स्यद्->स्याद्
स्यन्दनि->स्यन्दनी
स्यूमरश्मि->स्यूमरश्मी
स्रवितवे->स्रवितवै
स्रुत->स्रूत
स्वगा->स्वघा
स्वच्छन्दचर->स्वच्छन्दचार
स्वच्छन्दचर->स्वच्छन्दाचार
स्वजनय्->स्वजनाय्
स्वदन->स्वधन
स्वदयितर्->स्वादयितर्
स्वदान->स्वधन
स्वधित->स्वादित
स्वधिति->स्वधिती
स्वधीत->स्वादित
स्वधेनव->स्वधैनव
स्वपण->स्वापर
स्वयंभु->स्वयम्भू
स्वयंभु->स्वायम्भू
स्वयंभुव->स्वायम्भुव
स्वयंभू->स्वायम्भू
स्वयंभूक्षेत्रमाहात्म्य->स्वायम्भूक्षेत्रमाहात्म्य
स्वर्गत->स्वर्गात
स्वर्णकूट->स्वर्णकूठ
स्वर्णशेफालिका->स्वर्णसेफालिका
स्वल्प->स्वाल्प
स्ववशिनी->स्ववासिनी
स्ववशिनी->स्वावासिनी
स्वसर्->स्वसार्
स्वाति->स्वाती
स्वादुकर->स्वादुकार
स्वाद्य->स्वाध्य
स्वाहाकृति->स्वाहाकृती
स्वोरस->स्वौरस
हंसपदी->हंसपादी
हंसपरमेश्वर->हंसपारमेश्वर
हंसाङ्घ्रि->हंसाङ्घ्री
हटपर्णि->हटपर्णी
हनु->हनू
हनुमन्->हनुमान्
हनुमन्->हनूमान्
हन्तकार->हन्ताकार
हयगर्दभि->हयगर्धभि
हयवाहनशंकर->हयवाहनसंकर
हरक->हराक
हरणहारिक->हरणाहारिक
हरि->हरी
हरि->हारी
हरितत्त्वमुक्तावलि->हरितत्त्वमुक्तावली
हरिदश्व->हारिदश्व
हरिमन्->हरीमन्
हरिश्रावा->हरिस्रावा
हर्यमर->हर्यमाण
हर्या->हार्या
हलभृत्->हालभृत्
हलहला->हालाहला
हला->हाला
हलाहल->हालहाल
हलि->हली
हलि->हाली
हल्लीश->हल्लीस
हव्यवह्->हव्यवाह्
हव्यसूद्->हव्यासूद्
हसिका->हासिका
हस्तमुक्तावलि->हस्तमुक्तावली
हस्तयत->हस्तायत
हस्ताङ्गुलि->हस्ताङ्गुली
हस्तिनापुर->हास्तिनापुर
हस्तिशुण्डा->हस्तिसुण्डा
हहल->हहाल
हहल->हाहल
हहल->हाहाल
हाडि->हाडी
हारव->हाराव
हारि->हारी
हारीति->हारीती
हालहल->हालहाल
हास्तिनपुर->हास्तिनापुर
हास्यकर->हास्यकार
हिङ्गुलि->हिङ्गुली
हिङ्गुशिराटिका->हिङ्गुसिराटिका
हित->हीत
हिमपात->हिमापात
हिरण्यय->हिरण्याय
हिरण्यशृङ्ग->हिरण्यसृङ्ग
हिल->हीLअ
हिल->हील
हिलमोचि->हिलमोची
हुगलि->हुगली
हुड->हूड
हुतवह->हुतवाह
हुतहव्यवह->हुतहव्यवाह
हुन्->हून्
हुरस्->हूणस्
हुहु->हूहु
हुहू->हूहु
हृदयचोर->हृदयचौर
हेड->हेढ
हेमवत्->हैमवत्
हेमशिका->हेमशिखा
हेरम्ब->हेराम्ब
हेरम्भ->हेराम्ब
हो->हौ
होमि->होमी
ह्मल->ह्माल
ह्रणिया->ह्रणीया
ह्रादुनि->ह्रादुनी
ह्रित->ह्रीत
ह्रुडु->ह्रुडू
ह्रोड->ह्रौड
अधिष्ठातर्->अधिष्टातर्
अपची->अपचि
अपाञ्च्->अपञ्च्
अपत्यसाच्->अपत्यसच्
अपात्र->अपत्र
अपनाम->अपनम
अपाप->अपप
अपराङ्मुख->अपरङ्मुख
अपरथा->अपरता
अपराह्ण->अपराःण
अपराह्णक->अपराःणक
अपारपार->अपरापर
अपराभाव->अपराभव
अपरित्याज्य->अपरित्यज्य
अपरिहार->अपरिहाण
अपाणि->अपरी
अपरूप->अपरुप
अपालम्ब->अपलम्ब
अपवाद->अपवद
अपवारण->अपवरण
अपावृत्->अपवृत्
अपावृति->अपवृति
अपसद->अपशद
अपाश्रयिन्->अपश्रयिन्
अपश्री->अपश्रि
अपष्ठ->अपष्ट
अपाष्ठ->अपष्ट
अपष्ठु->अपष्टु
अपाश्या->अपस्या
अपहार->अपहर
अपीच्य->अपिच्य
अपीजू->अपिजू
अपीजू->अपीजु
अपूरण->अपुराण
अपूरुष->अपुरुष
अपेक्षाबुद्धि->अपेक्षबुद्धि
अप्राकरणिक->अप्रकरणिक
अप्राण->अप्रण
अप्रतिघात->अप्रतिगत
अप्रतीघात->अप्रतिगत
अप्रतिष्ठ->अप्रतिष्ट
अप्रमाद->अप्रमद
अप्रामाणिक->अप्रमाणिक
अप्रसक्त->अप्रशक्त
अप्रसक्ति->अप्रशक्ति
अफलाकाङ्क्षिन्->अफलकाङ्क्षिन्
अबाध->अबध
अभद्र->अबध्र
अभि->अबि
अभी->अबि
अभिध्या->अबिद्या
अभीत->अबीत
अभीर->अबीर
अब्धि->अब्दि
अब्राह्मण->अब्रह्मण
अभिघात->अभिगत
अभिधा->अभिदा
अभिनील->अभिनिल
अभीरु->अभिरु
अभीवर्ग->अभिवर्ग
अभीवर्त->अभिवर्त
अभिवाह->अभिवह
अभीवृत्->अभिवृत्
अभिसान्त्व->अभिशन्त्व
अभिसान्त्व->अभिशान्त्व
अभिश्री->अभिश्रि
अभिश्वास->अभिश्वस
अभीषह्->अभिषह्
अभीषह्->अभिषाह्
अभीषाह->अभिषाह
अभिसंपात->अभिसंपत
अभीशु->अभिसू
अभिहार->अभिहर
अभिह्वार->अभिह्वर
अभ्याचार->अभ्याचर
अभ्युपेत्याशुश्रूषा->अभ्युपेत्यशुश्रूषा
अभ्यूषीय->अभ्युषीय
अभ्यूह->अभ्युह
अभ्राय्->अभ्रय्
अमांस->अमंस
अमरागार->अमरगण
अमी->अमि
अमित्राय्->अमित्रय्
अमृतासु->अमृताशु
अम्भ्->अंब्
अम्भण->अंबर
अम्बूकृत->अम्बुकृत
अम्लसार->अम्लशार
अम्लीका->अम्लिका
अयाचित->अयचित
अयाथातथ्य->अयथातथ्य
अयाम->अयम
अयावन->अयवन
अयस्->अयश्
अयास्->अयश्
अयास्य->अयस्य
अयाथातथ्य->अयाथतथ्य
अररि->अरणी
अराणि->अरणी
अरण्यायन->अरण्ययान
अरण्यौकस्->अरण्योकस्
अरथ->अरत
अरथी->अरथि
अराति->अरथि
अराय->अरय
अरीढ->अरिढ
अरीति->अरिति
अर्घ्य->अर्ग्य
अर्थय्->अर्तय्
अर्ध->अर्द
अर्धिन्->अर्दिन्
अर्धहार->अर्धहर
अर्पिस->अर्पिश
अर्भ->अर्ब
अर्वावसु->अर्ववसु
अलास्य->अलस्य
अलीकसुप्त->अलिकसुप्त
अलीगर्द->अलिगर्ध
अवकाश->अवकश
अवगथ->अवगत
अवघात->अवगत
अवगुण्ठन->अवगुण्टन
अवघूर्ण->अवगूर्ण
अवाग्र->अवघ्र
अवतार->अवतर
अवनीपति->अवनिपति
अवपान->अवपन
अवाप->अवफ
अवभृथ->अवभृत
अवमान्य->अवमन्य
अवाय->अवय
अवयाज्->अवयज्
अवायु->अवयु
अवार्य->अवर्य
अवसित->अवशीत
अवसान->अवसन
अवाचीन->अवाचिन
अवान्तराम्->अवान्तरम्
अविघात->अविगत
अवीत->अवित
अविप्रणाश->अविप्रणश
अविष्ठ->अविष्ट
अव्यती->अव्यति
अव्यथि->अव्यति
अशनाया->अशनया
अशील->अशिल
अशून्य->अशुन्य
अशोचनीय->अशोचनिय
अश्मपृष्ठ->अश्मपृष्ट
अश्रीक->अश्रिक
अश्लीक->अश्लिक
अश्वापद्->अश्वपद्
अश्वापद्->अश्वपाद्
अश्वारोह->अश्वरोह
अश्वसृगालिका->अश्वशृगालिका
अश्वसूत->अश्वसुत
अष्टापद्->अष्टपाद्
अष्टारत्नि->अष्टरत्नि
अष्टसाहस्रक->अष्टसहस्रक
अष्ठि->अष्टी
असंसक्त->असंशक्त
असंस्थित->असंस्तीत
असांनिध्य->असंनिध्य
असंभाव्य->असम्भव्य
असंभाव्य->असंभव्य
असिक्नी->असिक्नि
असुख->असुक
असृग्धरा->असृग्दरा
असृग्धारा->असृग्दरा
अस्ताग->अस्तग
अस्ताघ->अस्तग
अस्थाग->अस्तग
अस्तमीके->अस्तमिके
अस्तम्भ->अस्तम्ब
अस्थि->अस्ती
अस्थिक->अस्तीक
अस्तुंकार->अस्तुंकर
अस्वाध्याय->अस्वध्याय
अस्वास्थ्य->अस्वस्थ्य
अहस्->अहश्
अहीन->अहिन
अहिवल्ली->अहिवल्लि
आख->आक
आखात->आकथ
आखन->आकन
आखान->आकन
आखा->आका
आखु->आकु
आकूत->आकुत
आखु->आकू
आक्षेपरूपक->आक्षेपरुपक
आघात->आगथ
आगमिष्ठ->आगमिष्ट
आग्नीध्र->आग्निध्र
आग्रहायण->आग्रहयण
आचाम->आचम
आचाम्य->आचम्य
आच्यादोह->आच्यदोह
आजकरौण->आजकरोण
आजान->आजन
आजीगर्त->आजिगर्त
आञ्छ्->आञ्च्
आञ्छन->आञ्चन
आठक->आटक
आटीकर->आटिकर
आढक->आडक
आडारक->आडाणक
आर->आण
आरुक->आणुक
आरुक->आणूक
आतान->आतन
आतिच्छन्दस->आतिच्छन्दश
आतिरैक्य->आतिरेक्य
आतीषादीय->आतीषदीय
आत्मबोध->आत्मबोद
आत्माराम->आत्मराम
आत्मावास्य->आत्मवश्य
आदान->आदन
आधान->आदन
आधारक->आदरक
आदारिन्->आदरिन्
आधर्य->आदर्य
आधार्य->आदर्य
आदिताल->आदितल
आदित्यपात्र->आदित्यपत्र
आदिसूर->आदिशूर
आधि->आदी
आधी->आदी
आधृष्टि->आदृष्टि
आध्या->आद्या
आधान->आधन
आनाथ्य->आनत्य
आनामन->आनमन
आनुसुक->आनुशूक
आनुसूक->आनुशूक
आन्वीक्षिकी->आन्वीक्षिकि
आपालि->आपलि
आपस्->आपश्
आपीत->आपित
आप्री->आप्रि
आबाल्यम्->आबल्यम्
आभील->आबिल
आभील->आभिल
आमात्य->आमत्य
आमात्य->आमथ्य
आयाति->आयती
आयास्य->आयस्य
आरातीय->आरतीय
आरम्भण->आरम्बण
आरी->आरि
आरुह्->आरुः
आरोध->आरोद
आर्चाभिन्->आर्चभिन्
आर्जीक->आर्जिक
आर्त्नी->आर्त्नि
आर्द्ध->आर्द्द
आलान->आलन
आलापिन्->आलपिन्
आलम्भ->आलंब
आलम्भिन्->आलंबिन्
आलम्भ्य->आलम्ब्य
आलोकगादाधरी->आलोकगदाधरी
आवार->आवण
आवार->आवर
आवारि->आवरि
आवास्य->आवश्य
आविस्->आविश्
आवेध->आवेद
आस्->आश्
आसक्ति->आशक्ति
आसार->आशार
आसिका->आशिका
आशिरःपादम्->आशिरःपदम्
आशिष्ठ->आशिष्ट
आसीन->आशीन
आसुक->आशुक
आसुत->आशुत
आसुति->आशुति
आसुर->आशूर
आस्माक->आश्मक
आस्य->आश्य
आस्या->आश्या
आस्रव->आश्राव
आस्राव->आश्राव
आश्वास्य->आश्वस्य
आषाढि->आषाडी
आसात्->आसत्
आस्तारक->आस्तरक
आहू->आहु
आहुतीष्टका->आहुतिष्टका
इलास्पद->इLअस्पद
इलादध->इLआदध
ईह्->इः
इख्->इक्
ईख्->इक्
इक्षुसार->इक्षुशर
इर्->इण्
ईर्->इण्
इन्दीवर->इन्दिवर
इन्दीवार->इन्दिवर
इन्दुकेसरिन्->इन्दुकेशरिन्
इन्दूर->इन्दुर
इन्द्रापर्वत->इन्द्रपर्वत
इन्द्राविष्णु->इन्द्रविष्णु
इन्द्रासोम->इन्द्रसोम
इभकेसर->इभकेशर
इभावन्त्->इभवन्त्
ईम्->इम्
ईर->इर
इष्टकापूरण->इष्टकापुराण
इष्टाहोत्रीय->इष्टहोत्रीय
ईष्व->इष्व
ईह्->ईः
उक्थपात्र->उक्थपत्र
उच्चारण->उच्चरण
उच्छून->उच्छुन
उच्छ्लख->उच्छ्लक
उज्जागर->उज्जगार
उत्कण्ठक->उत्कण्टक
उत्खली->उत्कलि
उत्कासन->उत्काशन
उत्क्वाथ->उत्क्वथ
उत्थापनीय->उत्तपनीय
उत्तराङ्ग->उत्तरङ्ग
उत्तरात्->उत्तरत्
उत्तराहि->उत्तरहि
उत्तार्य->उत्तर्य
उत्थापन->उत्तापन
उत्थानवीर->उत्थनवीर
उत्पलावती->उत्पलवती
उत्पलसारिवा->उत्पलशारिवा
उत्पाली->उत्पली
उत्फण->उत्पार
उत्सक्थ->उत्सक्त
उत्साद->उत्सद
उत्सादन->उत्सदन
उधन्->उदङ्
उदारक->उदरक
उदारसत्त्व->उदरसत्त्व
उदास्त->उदस्त
उदाहार->उदाहर
उदीची->उदिची
उदीची->उदीचि
उद्घ->उद्ग
उद्घात->उद्गत
उद्गाथा->उद्गाता
उद्घन->उद्गान
उद्घूर्ण->उद्गुर्ण
उद्घूर्ण->उद्गूर्ण
उद्ग्राह->उद्ग्रह
उद्घाटक->उद्घटक
उद्धान्त->उद्दान्त
उद्धय->उद्दाय
उद्धित->उद्दित
उद्ध्य->उद्द्य
उद्धान->उद्धन
उद्धूत->उद्धुत
उद्धूषित->उद्धुषित
उद्भूति->उद्भुति
उद्वाचन->उद्वचन
उपकार->उपकर
उपगीथ->उपगीत
उपाग्र->उपग्र
उपचारक->उपचरक
उपधान->उपधन
उपादान->उपधन
उपाधि->उपधी
उपाध्याय->उपध्याय
उपानह्->उपनह्
उपमात्->उपमथ्
उपायात->उपयात
उपारुह्->उपरुह्
उपलम्भ->उपलम्ब
उपालम्भ->उपलम्ब
उपालि->उपली
उपावसित->उपवासित
उपावि->उपवी
उपावी->उपवी
उपावृत्->उपवृत्
उपशान्ति->उपशन्ति
उपशामक->उपशमक
उपसान्त्वन->उपशान्त्वन
उपाश्रय->उपश्रय
उपश्री->उपश्रि
उपासङ्ग->उपसङ्ग
उपसंघात->उपसंगत
उपासङ्ग->उपसङ्घ
उपासन->उपसान
उपस्तार->उपस्तर
उपास्ति->उपस्थि
उपोदीका->उपोदिका
उभयतस्->उभयतश्
उम्भि->उंबी
उरस्->उरश्
उरोघात->उरोगत
ऊर्ज्->उर्ज्
ऊर्ज->उर्ज
ऊर्जस्कर->उर्जस्कर
ऊर्जित->उर्जित
ऊर्ण->उर्ण
ऊर्णनाभ->उर्णनाभ
ऊर्द्->उर्द्
ऊर्द->उर्द
ऊर्ध->उर्द
ऊर्व्->उर्व्
उलूक->उलुक
ऊलुपिन्->उलूपिन्
उल्लाल->उल्लल
उल्लास->उल्लस
उल्लासन->उल्लसन
उल्लू->उल्लु
ऊषण->उषर
ऊषर->उषर
उषासानक्ता->उषसानक्ता
उष्णांशु->उष्णंशु
उष्णासह->उष्णसह
उष्णीगङ्ग->उष्णिगङ्ग
उष्णीनाभ->उष्णिनाभ
उष्णीष->उष्णिष
ऊष्मज->उष्मज
ऊष्मप->उष्मप
ऊष्मपुर->उष्मपुर
ऊष्मवन्त्->उष्मवन्त्
ऊष्मा->उष्मा
ऊष्मायण->उष्मायण
ऊष्मोपगम->उष्मोपगम
ऊह->उह
ऊह्य->उह्य
ऊह्->ऊः
ऊर्णामय->ऊर्णमय
ऊर्ध्वथा->ऊर्ध्वता
ऊहनीय->ऊहनिय
ऋज्राश्व->ऋज्रश्व
ऋणादान->ऋणदान
ऋभुक्षीन्->ऋभुक्षिन्
एकाराम->एकरम
ऐकवर्णिक->एकवर्णिक
एकव्यावहारिक->एकव्यवहारिक
एकशील->एकशिल
एकाशीति->एकशीति
एकस्थान->एकस्तन
ऐकान्तिक->एकान्तिक
ऐकान्त्य->एकान्त्य
एकान्नादिन्->एकान्नदिन्
एकाष्ठील->एकाष्टील
ऐटत->एटत
ऐणिक->एणीक
ऐणिकीय->एणीकीय
ऐण->एर
ऐर->एर
एलापुर->एलपुर
ऐलवालुक->एलवालुक
एलावली->एलावलि
ऐलवालुक->एलावालुक
ऐषावीर->एषावीर
ऐडूक->ऐडुक
ऐन्द्रावरुण->ऐन्द्रवरुण
ऐन्द्रावारुण->ऐन्द्रवरुण
औक्थ->ओक्त
औत्स->ओत्स
औदन्य->ओदन्य
औषधि->ओषधी
औषधी->ओषधी
औष्ट्र->ओष्ट्र
औपसद->औपशद
औरसायनि->औरशायनि
औषधावली->औषधावलि
कंस्->कंश्
कंस->कंश
ककुभ्->ककुब्
काक->कख
काग->कग
कङ्कुष्ठ->कङ्कुष्ट
काङ्गुक->कङ्गुक
काचर->कचार
कच्छार->कच्छर
कच्छूमती->कच्छुमती
कच्छूराक्षस->कच्छुराक्षस
काञ्चनक->कञ्चनक
काञ्चनप्रभ->कञ्चनप्रभ
काञ्चि->कञ्ची
काञ्ची->कञ्ची
कञ्जार->कञ्जाण
कटाक्ष->कटक्ष
काटाक्ष->कटक्ष
कटप्रू->कटप्रु
कटार->कटर
कठर->कटर
कटस्थाल->कटस्थल
कठाकु->कटाकु
कठिका->कटिका
कठिनता->कटिनता
कठिनय्->कटिनय्
कठिनी->कटिनी
कठिल्लक->कटिल्लक
कटिशृङ्खला->कटिशृङ्कला
कठोपनिषद्->कटोपनिषद्
कठोरचित्त->कटोरचित्त
कट्टार->कट्टण
काट्य->कट्य
काठक->कठक
काठशाठिन्->कठशाठिन्
कडार->कडर
करक->कणक
कारक->कणक
करबक->कणभक
करभक->कणभक
कारव->कणव
करशीकर->कणशीकर
कारा->कणा
करिन्->कणिन्
कारिन्->कणिन्
करिष्ठ->कणिष्ठ
करि->कणी
करी->कणी
कारि->कणी
कर्करि->कण्काणि
कण्टकश्रेणी->कण्टकश्रेणि
कण्टकीद्रुम->कण्टकिद्रुम
कण्ठगत->कण्टगत
कण्ठग्रह->कण्टग्रह
कण्ठभूषण->कण्टभूषण
कण्ठाश्लेष->कण्टश्लेष
काण्ड->कण्ड
काण्डनी->कण्डनी
काण्डार->कण्डार
कण्डूय्->कण्डुय्
काण्वीय->कण्वीय
कात्->कत्
कात्->कथ्
कदलीगर्भा->कदलिगर्भा
कादाचित्क->कदाचित्क
कधि->कदि
कनकाह्वय->कनकाःवय
कनकावली->कनकावलि
कानच्->कनच्
कानन->कनन
कनी->कनि
कनिष्ठ->कनिष्ट
कनिष्ठक->कनिष्टक
कान्ति->कन्ति
कान्ती->कन्ति
कन्दालु->कन्दलु
कान्द->कन्ध
कन्याका->कन्यका
कन्यकुमारी->कन्यकुमारि
कन्याकुमारी->कन्यकुमारि
कापालिक->कपालिक
कापालि->कपाली
कपीकच्छु->कपिकच्छू
कापिञ्जलि->कपिञ्जली
कपीत->कपित
कपीतक->कपिथक
कपिलावट->कपिलवट
कपिलाह्रद->कपिलह्रद
कापिशायन->कपिशायन
कापिष्ठल->कपिष्ठाल
कापोति->कपोती
कापाल->कफल
काफल->कफल
कापा->कफा
कापिल->कफिल
कापी->कफी
काम->कम
कमठ->कमट
कामठ->कमट
कामन्दक->कमन्दक
कामलकीट->कमलकीट
कामलिन्->कमलिन्
कामलि->कमली
कामालिका->कमलीका
कामिता->कमिता
काम्पिल्यक->कम्पिल्यक
कम्फिल्ल->कंपिल्ल
काम्पिल्ल->कंपिल्ल
कम्फिल्ल->कम्पिल्ल
काम्पिल्ल->कम्पिल्ल
काम्पिल्लक->कम्पिल्लक
काम्पिल->कम्पील
काम्पील->कम्पील
कम्भ->कम्ब
कम्बू->कंबु
कम्भु->कंबु
काम्बुका->कम्बुका
कम्भु->कंबू
काम्बोजि->कम्बोजी
कम्भारी->कम्भारि
कराङ्गण->करङ्गण
कारणिक->करणिक
करपात्र->करपत्र
करापात->करपात
कारपथ->करपात
कारापथ->करपात
कारभू->करभू
काराभू->करभू
करभोरू->करभोरु
करम्भ->करंब
कारम्भा->करम्भा
कराल->करल
कारव->करव
करशाखा->करशाका
करशूक->करशुक
कारसूत्र->करसुत्र
कारसूत्र->करसूत्र
करालकेसर->करालकेशर
कारु->करू
कारोतर->करोतर
कारोती->करोति
कर्करीका->कर्करिका
कर्कारु->कर्करु
कार्कण->कर्कार
कर्णकण्डू->कर्णकण्डु
कर्णपूर->कर्णपुर
कर्णस्रोतस्->कर्णश्रोतस्
कर्णीसुत->कर्णिसुत
कार्दमि->कर्दमी
कार्पणी->कर्परी
कर्बूरित->कर्बुरित
कर्मठ->कर्मट
कार्मरङ्ग->कर्मरङ्ग
कलह्->कलः
कलाङ्कुर->कलङ्कुर
कलाद->कलद
कलधूत->कलधुत
कलाम्बि->कलम्बी
कलम्बू->कलम्बु
कलाम्बि->कलम्भि
कलाची->कलाचि
कल्कालय->कल्कलाय
कल्पवल्ली->कल्पवल्लि
कवाट->कवट
कवयी->कवयि
कवार->कवर
कवारि->कवरी
कविलासिका->कविलाशिका
कशीका->कशिका
कसेरु->कशेरु
कसेरु->कशेरू
कषीका->कषिका
कस्तूरी->कस्तूरि
कांस्यनील->कांश्यनील
काकखर->काककण
काकरन्ति->काकणन्ती
काकारि->काकणी
काकार->काकर
काकुदीक->काकुदिक
काठकोपनिषद्->काटकोपनिषद्
कारि->काणि
काण्व->काण्Vअ
काण्डपृष्ठ->काण्डपृष्ट
कात्यायनिका->कात्ययनिका
कान्थिक->कान्तीक
कापाटिक->कापटिक
कामरूपिन्->कामरुपिन्
कामालिका->कामलिका
कामशास्त्र->कामशस्त्र
कामाशोक->कामशोक
कारणकारण->कारणकरण
कारणशरीर->कारणशरिर
कार्यकारण->कार्यकरण
कार्यार्थिन्->कार्यर्थिन्
कार्शानव->कार्शनव
कार्षापण->कार्षपण
कालकाक्ष->कालकक्ष
कालपृष्ठ->कालपृष्ट
कालमार्ताण्ड->कालमार्तण्ड
कालहार->कालहर
कालानुसारिवा->कालानुशारिवा
काली->कालि
कालोदायिन्->कालोदयिन्
काल्याणिनेय->काल्यणिनेय
कासमर्द->काशमर्द
कासिका->काशिका
काशीपति->काशिपति
काशू->काशु
कासू->काशु
कासेरुयज्ञिक->काशेरुयज्ञिक
काष्ठकुद्दाल->काष्टकुद्दाल
काष्ठसारिवा->काष्ठशारिवा
कीकट->किकट
किकिदीवि->किकिदिवि
किखि->किकी
कीकि->किकी
किंकर->किंकण
किङ्किणीकाश्रम->किङ्किणिकाश्रम
कीचक->किचक
कीटक->किटक
किरि->किणी
कीरि->किणी
किर्मीर->किर्मिर
किसर->किशर
किसरिक->किशरिक
किसल->किशल
किसलय->किशलय
कीकस->कीकश
कीर्तिभाज्->कीर्तिभज्
कुह्->कुः
कुकुर->कुकुण
कुकुन्ध->कुकुन्द
कूची->कुचि
कूचिका->कुचिका
कूचीका->कुचिका
कुठारिक->कुटारिक
कुटीमह->कुटिमह
कुठेर->कुटेर
कुट्टापरान्त->कुट्टपरान्त
कुट्टापरान्त->कुट्टापरन्त
कुडूहुञ्ची->कुडुहुञ्ची
कुण्ठ->कुण्ट
कुण्डलीका->कुण्डलिका
कुथ->कुत
कुथक->कुतक
कुद्दाल->कुद्दल
कूद्दाल->कुद्दल
कुध्र->कुद्र
कूपाङ्क->कुपङ्क
कुपथ->कुपत
कुमारी->कुमारि
कुम्भीक->कुम्बिक
कुम्भीनस->कुम्भिनस
कूर->कुर
कूर्द->कुर्द
कूर्पासक->कुर्पासक
कुलघ्न->कुलग्न
कुलाह->कुलह
कूलचर->कुलाचार
कूलि->कुली
कूलिक->कुलीक
कुशावती->कुशवति
कुशावती->कुशवती
कुशाल्मली->कुशाल्मलि
कुसित->कुशित
कुसि->कुशी
कुसिद->कुशीद
कुसीद->कुशीद
कुसुम्भ->कुशुम्भ
कुसूल->कुशूल
कुसू->कुसु
कुसुमायुध->कुसुमयुध
कुसुमसार->कुसुमसर
कुसुम्भ->कुसुम्ब
कूश्म->कुस्म
कूहना->कुहना
कूटशाल्मलि->कूटशल्मलि
कूर->कूण
कूवार->कूवर
कृकदाशू->कृकदाशु
कृकलास->कृकलाश
कृतकाम->कृतकम
कृतादर->कृतधार
कृताय->कृतय
कृतावसक्थिक->कृतावशक्थिक
कृसर->कृशर
कृषाण->कृषर
कृष्णागुरु->कृष्णगुरु
कृष्णसार->कृष्णशार
कैकय->केकाय
कैतव->केतव
केयूर->केयुर
कैरली->केरली
कैरव->केरव
कैलास->केलास
केवाली->केवली
केसर->केशर
केसराग्र->केशराग्र
केसराचल->केशराचल
केसराम्ल->केशराम्ल
केसराल->केशराल
केशारि->केशरि
केसरि->केशरि
केसरिका->केशरिका
केसरिन्->केशरिन्
केसरिसुत->केशरिसुत
केशारि->केशरी
केसरि->केशरी
केसारुका->केशारुका
कैलास->कैलाश
कोटिकास्य->कोटिकाश्य
कौम्भ->कोम्ब
खोल्->कोल्
कोलनासिका->कोलनाशिका
कोलशिम्बी->कोलशिम्बि
कौलिक->कोलिक
कौलीक->कोलिक
कौलि->कोली
खोलि->कोली
कौलूत->कोलूत
कोसल->कोशल
कौशल->कोशल
कौसल->कोशल
कौशलिका->कोशलिका
कौशिक->कोशिक
कौशीधान्य->कोशीधान्य
कौश->कोस
कौसलक->कोसलक
कौचापाक->कौचपक
खोटि->कौटि
कौनखीय->कौनकीय
कौमोदकी->कौमोदकि
खोर->कौर
कौरुकात्य->कौरुकत्य
कौरुपथि->कौरुपति
कौलीनि->कौलिनी
खोलि->कौली
कौसलक->कौशलक
कौसलेय->कौशलेय
कौसल्यानन्दन->कौशल्यानन्दन
कौषारव->कौषरव
कौषीतक->कौषितक
कौहलीय->कौहलिय
क्नूय्->क्नूञ्
क्रतूय्->क्रतुय्
क्रमागत->क्रमगत
क्रायक->क्रयक
क्रियाकार->क्रियाकर
क्रौञ्चपदा->क्रोञ्चपदा
क्रौलायन->क्रोलायन
क्रौष्टुकि->क्रोष्टुकी
क्लिध->क्लिद
क्लीब->क्लिब
क्षर्->क्षण्
क्षात्त्र->क्षत्त्र
क्षात्रि->क्षत्रि
क्षात्रि->क्षत्री
क्षपणी->क्षपणि
क्षामि->क्षमी
क्षयद्वीर->क्षयद्विर
क्षाल->क्षल
क्षीण->क्षिण
क्षीर->क्षिण
क्षीण->क्षिर
क्षीर->क्षिर
क्षीरपाण->क्षीणपण
क्षीरधि->क्षीणाधि
क्षीरस्राव->क्षीणाश्रव
क्षीरस्राव->क्षीणास्रव
क्षीरजाल->क्षीरजल
क्षीरतैल->क्षीरतेल
क्षीरपाक->क्षीरपक
क्षीरषाष्टिक->क्षीरषष्टिक
क्षौणी->क्षोणी
क्षौणीभुज्->क्षोणीभुज्
क्षौणीभृत्->क्षोणीभृत्
क्षौणी->क्षौणि
खक्ख्->खक्क्
खगाधिप->खगधिप
खञ्जार->खञ्जर
खाञ्जार->खञ्जर
खाञ्जाल->खञ्जाल
खाटिका->खटिका
खाटि->खटी
खडतू->खडतु
खाडी->खडि
खाडी->खडी
खडू->खडु
खड्गारीट->खड्गारिट
खण्डसार->खण्डसर
खण्डी->खण्डि
खाद->खद
खादूरक->खदूरक
खाद्य->खद्य
खानि->खनी
खरकुटी->खरकुटि
खरपात्र->खरपत्र
खरमयूख->खरमयूक
खर्बूज->खर्बुज
खलीकार->खलिकार
खस->खश
खसीक->खशिक
खशीर->खशिर
खाशीर->खशिर
खिङ्खिर->खिङ्किर
गागनायस->गगनायस
गाङ्ग->गङ्ग
गाङ्गेष्ठी->गङ्गेष्टि
गजपिप्पली->गजपिप्पलि
गजी->गजि
गड्डारिका->गड्डरिका
गर्->गण्
गणनायक->गणनयक
गणपाठ->गणपाट
गणश्री->गणश्रि
गरिका->गणिका
गण्डाली->गण्डली
गर्व->गण्व
गतीक->गतिक
गदागद->गदगद
गन्धमांसी->गन्धमांसि
गरिष्ठ->गरिष्ट
गर्धन->गर्दन
गर्भ->गर्ब
गर्मूच्छद->गर्मुच्छद
गर्वर->गर्वण
गविष्ठ->गविष्ट
घण्ड->गाण्ड
गाण्डी->गाण्डि
घाति->गाथि
घाति->गाथी
घनी->गानी
घर्म्य->गार्म्य
गार्हस्थ्य->गार्हस्त्य
घस्->गास्
गिरीयक->गिरियाक
गीथा->गीता
घिण्->गीर्
घुट्->गुठ्
घुट->गुठ
गुर्->गुण्
गूर्->गुण्
घुण्->गुण्
घुर्->गुण्
घूर्->गुण्
गुणग्राहिन्->गुणग्रहिन्
गुणान्वित->गुणन्वित
गुणावरा->गुणवरा
गुणी->गुणि
घुणि->गुणि
घुरिका->गुणिका
घुण्ट->गुण्ठ
गुध्->गुद्
घुम्->गुम्
घुण->गुर
घुणि->गुरी
घुलञ्च->गुलञ्च
गूला->गुला
गूह्->गूः
गूढपाद->गूढपद
घुण->गूर
घुणि->गूरी
घूर्णिका->गूर्णिका
गृध्रकूट->गृध्रकुट
गृहाचार->गृहचार
गृहाय->गृहय
गृह्यासंग्रह->गृह्यसंग्रह
गोचारक->गोचरक
घोणा->गोणा
गौरी->गोणि
गौणिक->गोणिक
गौरिक->गोणिक
घोणिक->गोणिक
गौरी->गोणी
गौरीपति->गोणीपति
गौरीपुत्र->गोणीपुत्र
गौतमि->गोतमी
गोदावरी->गोदावरि
गोनस->गोनश
गोनास->गोनश
घोनस->गोनश
गोपाय->गोपय
गोपीत->गोपित
गोपीथ->गोपित
गौपिक->गोपीक
गोपोतालिका->गोपोतलिका
गोमथ->गोमत
गौमत->गोमत
गोमतीपुत्र->गोमतिपुत्र
गौरास्य->गोरास्य
गौला->गोला
गोवीथी->गोवीथि
गोसशश->गोशशस
घोष->गोष
गोष्ठ->गोष्ट
गौष्ठ->गोष्ट
गोष्ठीशाला->गोष्ठिशाला
गोहरीतकी->गोहरितकी
गौरचन्द्र->गौणचान्द्र
गौरी->गौणी
गौधेय->गौदेय
गौरखर->गौरकर
घोराकार->गौरकर
घोरता->गौरता
घोरवाशन->गौरवासन
घोणा->गौरा
गौरी->गौरि
घ्राति->ग्रथि
ग्रामकुक्कुट->ग्रमकुक्कुट
ग्रामघात->ग्रमघात
ग्रामदशेश->ग्रमदशेश
ग्राम्य->ग्रम्य
ग्रास->ग्रस
ग्राहिक->ग्रहिक
ग्रामघात->ग्रामगत
ग्राम्यसूकर->ग्राम्यशूकर
ग्रावस्तोत्रीय->ग्रावस्तोत्रिय
ग्रैष्म->ग्रेष्म
घटीका->घटिका
घटीकार->घटीकर
घार->घण
घण्टाकर्ण->घण्टकर्ण
घण्टाली->घण्टालि
घातन->घतन
घनाघन->घनघन
घनोरू->घनोरु
घार->घर
घर्घरक->घर्गरक
घासि->घसि
घाटाल->घाटल
घूत्कार->घुत्कार
घृष्ठिला->घृष्टिला
घोर->घोण
घौर->घोण
घोषादी->घोषादि
घ्राति->घ्रति
चक्रपात->चक्रपथ
चक्रपाद->चक्रपद
चक्षुस्->चक्षुश्
चण्डीस्तोत्र->चण्डिस्तोत्र
चण्डीसपर्याक्रम->चण्डीशपर्याक्रम
चतुःस्थान->चतुःस्तन
चतुरूषण->चतुरुषण
चतुर्थकाल->चतुर्थकल
चतुस्->चतुश्
चन्दनाय्->चन्दनय्
चन्दनसारिवा->चन्दनशारिवा
चन्धनि->चन्दनी
चन्द्रावती->चन्द्रवती
चमीकार->चमीकर
चमू->चमु
चरण्टी->चरण्टि
चारुक->चरुक
चर्मखाण्डिक->चर्मखण्डिक
चालनिका->चलनिका
छलय्->चलाय्
छलितक->चलितक
छलितराम->चलितराम
छवि->चवी
चाष->चष
छा->चा
छागलेयिन्->चागलेयिन्
चातुर्मासी->चातुर्मसी
चातुर्वैद्य->चातुर्वेद्य
छदि->चादि
चारुकेसरा->चारुकेशरा
चारुरूप->चारुरुप
छिक्का->चिक्का
चीय्->चिञ्
चित्कार->चित्कण
चीत्कार->चित्कण
चीत्कारवन्त्->चित्कारवन्त्
चित्रताल->चित्रतल
चित्रपादा->चित्रपदा
चित्रराति->चित्ररथी
चित्रशिखण्डिप्रसूत->चित्रशिखण्डिप्रसुत
चित्रौदन->चित्रोदन
छिदि->चिदि
चीमनिचरित्र->चिमनीचरित्र
चिरातिक्त->चिरतिक्त
चिरान्तक->चिरन्तक
चीरपर्ण->चिरपर्ण
चीरिन्->चिरिन्
चीरिल्लि->चिरिल्ली
चिलिचीमि->चिलिचिमि
चीचीकूची->चीचीकुची
चुक्रवास्तूक->चुक्रवास्तुक
छुच्छु->चुच्चू
चूड->चुड
चूडामणि->चुडामणि
छुड्ड->चुड्ड
छुड्->चुढ्
चुर->चुण
चुण्टी->चुण्टि
चूति->चुति
चुरी->चुरि
चूरि->चुरि
चूरी->चुरि
छुरी->चुरि
छूरी->चुरि
चूरु->चुरू
छुरिका->चूरिका
छूरिका->चूरिका
चूर्णीकरण->चूर्णिकरण
छेक->चेक
छेदि->चेदी
चैत्रकूटी->चैत्रकुटी
छोटि->चोटी
चौडि->चोडी
चौदायनि->चोदायनि
चौरंकारम्->चोरंकारम्
चौरिका->चोरिका
चौरी->चोरी
चौरोद्धरणिक->चोरोद्धरणिक
चौलि->चोली
चौलुक्य->चोलुक्य
चौरी->चौरि
च्यौत्न->च्योत्न
छगलाण्ड->छगलण्ड
छागलाण्ड->छगलण्ड
छगलाङ्घ्री->छगलाङ्घ्रि
छागलि->छगली
छत्त्रधार->छत्त्रधर
छन्दस्->छन्दश्
छान्दोग->छन्दोघ
छान्दोविचित->छन्दोविचित
छिक्कर->छिक्कण
छिक्कार->छिक्कण
छैदिक->छेदिक
जागरिष्णु->जगरिष्णु
जागर->जगार
जङ्घाल->जङ्घल
जाङ्गल->जङ्घल
जज्ञान->जज्ञन
जाटालिका->जटालिका
जाटिकायन->जटिकायन
जातूकर्णीपुत्र->जतुकर्णीपुत्र
जतूका->जतुका
जातु->जतू
जातू->जतू
जनीय->जनिय
जानु->जनू
जनौ->जनो
जन्माधिप->जन्मदीप
जंपती->जम्पति
जम्बूखण्ड->जम्बुखण्ड
जाम्बूनदमय->जम्बूनदमय
जम्भारि->जम्भरि
जयावह->जयवह
जयावह->जयवाह
जाया->जया
जारण->जरर
जरूथ->जरुथ
जलाकर->जलकर
जालकार->जलकर
जलाञ्जलि->जलञ्जलि
जालबन्ध->जलबन्ध
जलरूप->जलरुप
जलसूचि->जलशुचि
जलसूकर->जलशूकर
जविष्ठ->जविष्ट
जागरूक->जागरुक
जाघनी->जाघनि
जाङ्घालायन->जाङ्घलायन
जाटालिका->जाटलिका
जातिसांकर्यवाद->जातिसंकर्यवाद
जातूकर्ण->जातुकर्ण
जान्वाक्न->जान्वक्न
जाम्बूनदमय->जाम्बुनदमय
जारमाण्य->जारमण्य
जिङ्गी->जिङ्गि
जीत->जित
जीव्->जिव्
जीव->जिव
जीवनि->जिवनी
जीवशंस->जिवशंस
जिवाजीव->जिवाजिव
जीवजीव->जिवाजिव
जिह्मशी->जिह्मशि
जूक->जुक
जूमरनन्दिन्->जुमरनन्दिन्
जूर्व्->जुर्व्
जुहू->जुहु
जुहूराण->जुहुरण
जुहूराण->जुहुराण
जैत्र->जेत्र
जैन->जेन
ज्ञास्->ज्ञस्
ज्ञानावरणीय->ज्ञानवरणीय
ज्यानि->ज्ञानी
ज्यैष्ठसामिक->ज्येष्ठसामिक
ज्यैष्ठ्य->ज्येष्ठ्य
ज्योतीरत->ज्योतिरत
ज्योतीरथ->ज्योतिरत
ज्योतिस्->ज्योतिश्
ज्यौतिषिक->ज्योतिषीक
ज्योत्स्नी->ज्योत्स्नि
ज्वरातीसार->ज्वरातिसार
ज्वालारासभकामय->ज्वलारासभकामय
ज्वालिन्->ज्वलिन्
ज्वालाखरगद->ज्वालखरगद
ज्वालाजिह्व->ज्वालजिह्व
ज्वालामुखीस्तोत्र->ज्वालामुखिस्तोत्र
झाट->झट
झर->झण
झणत्कार->झणत्कर
झर्झर->झर्जर
झार्झर->झर्जर
झिञ्झिम->झिञ्जिम
झिरिका->झिणिका
झीरिका->झिणिका
झीरिका->झिरीका
टाक->टक
ठकार->टकार
टगर->टगण
ठात्कार->टात्कार
टीका->टिका
टीटिभ->टिटिभ
डङ्गारी->डङ्गरी
डाङ्गरी->डङ्गरी
डम्भ्->डंब्
डम्बार->डंबर
डाहल->डहाल
डाहाल->डहाल
डाकिनी->डाकिनि
ढाल->डाल
डिम्भ्->डिम्ब्
ढुण्ढि->डुण्ढि
ढाल->ढल
ढुण्ढि->ढुण्डि
तक्रकूर्चिका->तक्रकुर्चिका
तगर->तगण
ताड->तड
ताण्डि->तण्डी
तण्डूलिकाश्रम->तण्डुलिकाश्रम
तथार्थ->ततर्थ
तातृपि->ततृपि
तथ्य->तत्य
तात्य->तत्य
तादुरी->तदुरी
तादृश->तदृश
ताद्धर्म्य->तद्धर्म्य
तद्भाव->तद्भव
तनूबल->तनुबल
तनूरुह->तनुरुह
तनूकृथ->तनूकृत
तानूनपात->तनूनपात
तन्द्राय्->तन्द्रय्
तपस्->तपश्
तपस->तपश
तापस->तपश
तप्तसूर्मि->तप्तशूर्मि
तामसवन->तमसावन
तामलकी->तमालकी
तमिषीची->तमिषीचि
तामि->तमी
तामु->तमु
तायादर->तयादर
तारटी->तरटी
तारणि->तरणी
तारारि->तरणी
तारापति->तरपति
ताराज्->तराज्
तारायण->तरायण
तारावली->तरावली
तरूट->तरुट
तरुणी->तरुणि
तरुतूलिका->तरुतुलिका
तर्दू->तर्दु
तालवन->तलवन
तालक->तलाक
ताव्->तव्
तापायन->तापयान
ताम्बूलिक->ताम्बुलिक
ताम्रपात्र->ताम्रपत्र
ताम्रावती->ताम्रवती
तारकाराज->तारकराज
ताराग्रह->तारग्रह
तार्तीय->तार्तिय
तालाकट->तालकट
तालाङ्क->तालङ्क
तासून->तासुन
तिणिस->तिणिश
तिथि->तिति
तिन्दुकी->तिन्दुकि
तीर->तिर
तिरश्ची->तिरश्चि
तिर्यग्घातिन्->तिर्यग्गतिन्
तिलकाय्->तिलकय्
तीर्थपाद->तीर्थपद
तीर्थराजी->तीर्थराजि
तूख->तुक
तुडी->तुडि
तुर->तुण
तूण->तुण
तूर->तुण
तूणव->तुणव
तूणिक->तुणिक
तूणीक->तुणिक
तूणीर->तुणीर
तुभ्->तुब्
तुभ->तुब
तूर्वयाण->तुर्वयण
तूर्वि->तुर्वी
तूलक->तुलक
तूलिफला->तुलिफला
तूलि->तुली
तुवीरव->तुविरव
तुषाग्नि->तुषग्नि
तृणपूली->तृणपुली
तृणबिन्दुसरस्->तृणबिन्दुशरस्
तृफला->तृपला
तृम्फण->तृम्पण
तृम्फणीय->तृम्पणीय
तृष्यावन्त्->तृष्यवन्त्
तैलचौरिका->तैलचोरिका
तोयनीवी->तोयनिवी
तौरयाण->तौरयण
त्रख्->त्रक्
त्रिफल->त्रिपल
त्रिपुराभैरवी->त्रिपुरभैरवी
त्रिपृष्ठ->त्रिपृष्ट
त्रिभाण्डी->त्रिभण्डी
त्रिविष्टिधातु->त्रिविष्टिधतु
त्रिशाण->त्रिशर
त्रिसर->त्रिशर
त्रिसाहस्र->त्रिसहस्र
त्रैध->त्रेध
त्र्याक्षायण->त्र्यक्षायण
त्र्यहीन->त्र्यहिन
त्र्युदाय->त्र्युदय
त्वाष्ट्र->त्वष्ट्र
त्वै->त्वे
दंसि->दंशी
दह्->दः
दाक्षक->दक्षक
दक्षिणापथ->दक्षिणपथ
दक्षिणाबन्ध->दक्षिणबन्ध
दाक्षि->दक्षी
दाक्ष्य->दक्ष्य
दण्डपांसुल->दण्डपांशुल
दाण्डपाणिक->दण्डपाणिक
दाण्डपाशिक->दण्डपाशिक
दण्डवालधि->दण्डवलधि
दत्तामित्र->दत्तमित्र
दात्त->दत्थ
दादद->ददद
दधित्थ->ददित्थ
दाधित्थ->ददित्थ
दधिसार->दधिसर
दनायू->दनायु
दान्ति->दन्ती
दन्तूल->दन्तुल
दन्तोलूखलिक->दन्तोलुखलिक
दन्दशूक->दन्दशुक
दभीति->दभिति
दामनि->दमनी
दामनी->दमनी
दामनीय->दमनीय
दामा->दमा
दाय->दय
दारक->दरक
दरीमुख->दरिमुख
दारि->दरी
दर्भ->दर्ब
दार्भ->दर्ब
दर्भट->दर्बट
दर्भि->दर्बि
दार्भि->दर्बि
दर्भर->दर्भण
दर्भपूतीक->दर्भपूतिक
दार्भ्य->दर्भ्य
दर्वीकर->दर्विकर
दर्शनावरणीय->दर्शनवरणीय
दाल्भि->दल्भि
दस्->दश्
दाश्->दश्
दास्->दश्
दशान्त->दशन्त
दशपूरुष->दशपुरुष
दाशमूलिक->दशमूलिक
दाशरात्रिक->दशरात्रिक
दासवर्ग->दशवर्ग
दशावर->दशवार
दशसाहस्र->दशसहस्र
दशास्य->दशस्य
दासी->दशि
दस्र->दश्र
दास्र->दश्र
दासी->दसि
दाशु->दसु
दाशेरक->दसेरक
दासेरक->दसेरक
दाक्षायण->दाक्षयाण
दाक्षिकन्थीय->दाक्षिकन्थिय
दाय्->दाञ्
दाडी->दाडि
दार->दाण
दारि->दाणि
दानखण्ड->दानकाण्ड
दासमेय->दाशमेय
दासशिरस्->दाशशिरस्
दासी->दाशी
दासी->दासि
दीक्ष्->दिक्ष्
दीक्षणीय->दिक्षणीय
दीक्षा->दिक्षा
दीक्षापति->दिक्षापति
दिण्डीर->दिण्डिर
दिधिषूपति->दिधिषुपति
दिधीषू->दिधिषू
दिधीषू->दिधीषु
दीनार->दिनार
दीन्नार->दिन्नार
दिव्यरूप->दिव्यरुप
दिव्यौघ->दिव्योघ
दीधि->दीदी
दीधी->दीदी
दीर्घकण्ठक->दीर्घकण्टक
दीर्घायुस्->दीर्घयुस्
दुःशास->दुःशस
दुःशासन->दुःशसन
दुध्->दुद्
दुद्यूषु->दुद्युषु
दुराधी->दुराधि
दुरूह->दुरुह
दुर्गादत्त->दुर्गदत्त
दुर्गादास->दुर्गदास
दुर्गासावित्री->दुर्गासावित्रि
दुर्धर->दुर्दार
दुर्दुरूट->दुर्दुरुट
दुर्धुरूट->दुर्दुरुट
दूर्व->दुर्व
दुर्वाचकयोग->दुर्वचकयोग
धूर्वी->दुर्वी
दुर्हार्द्->दुर्हर्द्
धूलि->दुली
धूली->दुली
दुस्->दुश्
धूश्->दुश्
धूस्->दुश्
दूष->दुष
दुष्टरीतु->दुष्टरितु
दुस्त्याज्य->दुस्त्यज्य
दूतीका->दूतिका
दूराध->दूरद
धुरा->दूरा
धूर्वा->दूर्वा
दूलास->दूलाश
धूलि->दूली
धूली->दूली
धृक्->दृक्
धृत->दृत
धृष्टकेतु->दृष्टकेतु
दैवतस्->देवतस्
देवातिथि->देवतिथि
देवनदी->देवनदि
दैवपर->देवपर
दैवस्थानि->देवस्थानि
दैवाप->देवाप
देवावास->देवावस
दैववश->देवावस
देशीकोश->देशिकोश
देशीनाममाला->देशीनममाला
देहली->देहलि
दैवादिक->दैवदिक
दौःसाधिक->दोःसाधिक
दोध->दोद
दौर्गन्ध्य->दोर्गन्ध्य
दौर्मद्य->दोर्मध्य
दोषाय्->दोषय्
द्यावाभूमी->द्यावाभूमि
द्रुह्->द्रुः
द्रौणी->द्रोणी
द्रौणेय->द्रोणेय
द्रौणी->द्रौणि
द्वादशमहावाक्य->द्वदशमहावाक्य
द्वारिन्->द्वरिन्
द्वादशवार्षिक->द्वादशवर्षिक
द्विपृष्ठ->द्विपृष्ट
द्विभाग->द्विभग
द्विरदान्तक->द्विरदन्तक
द्विरभ्यासाकूपार->द्विरभ्यासाकूपर
द्विरूढा->द्विरुढा
द्विवेसरा->द्विवेशरा
द्विष्ठ->द्विष्ट
द्वैतवन->द्वेतवन
द्वैध->द्वेद
द्वैधीभाव->द्वैधिभाव
धाटी->धटी
धर->धण
धार->धण
धनच्छू->धनच्छु
धनीका->धनिका
धानिका->धनिका
धानेय->धनेय
धन्ध->धन्द
धामनिका->धमनिका
धामनी->धमनी
धाणक->धरक
धारक->धरक
धरणीधृत्->धरणिधृत्
धरणीभृत्->धरणिभृत्
धरणीरुह->धरणिरुह
धारणि->धरणी
धरणीपूर->धरणीपुर
धारयत्कवि->धरयत्कवि
धारा->धरा
धराधारा->धराधरा
धाराफल->धरापाल
धर्माकर->धर्मकार
धर्मधृक्->धर्मदृक्
धार्मविद्य->धर्मविद्य
धर्माधिकारणिक->धर्माधिकरणिक
धावन->धवन
धवनी->धवनि
धावनि->धवनि
धारिका->धाणिका
धातकीखण्ड->धातकिखण्ड
धातुकासीस->धातुकाशीश
धान्यकोष्ठक->धान्यकोष्टक
धान्याद->धान्यद
धारणापारणव्रत->धारणपारणव्रत
धितावन्->धितवन्
धीरस्कन्ध->धीरस्कन्द
धीलटी->धीलटि
धूत->धुत
धूतपाप->धुतपाप
धूति->धुति
धून->धुन
धूनन->धुनन
धूनन->धुनान
धून्वन्त्->धुन्वन्त्
धूर्वी->धुर्वी
धूमावती->धूमवती
धूमशिखा->धूमशिका
धूमीका->धूमिका
धूलीकदम्ब->धूलिकदम्ब
धूलीमय->धूलिमय
धूस्तूर->धूस्तुर
धौर->धोर
धौरितक->धोरितक
धौतरी->धौतरि
ध्राज->ध्रज
ध्वंसि->ध्वंशि
ध्वंसि->ध्वंशी
नल->नLअ
नाल->नLअ
नह्->नः
नकार->नकर
नखर->नकर
नाकुलान्ध्य->नकुलान्ध्य
नाकुलि->नकुली
नक्षत्रवीथी->नक्षत्रवीथि
नखारि->नखरी
नखालु->नखलु
नागर्य->नगण्य
नागरखण्ड->नगरखण्ड
नागराज->नगराज
नगारि->नगरी
नागारि->नगरी
नागाधिराज->नगाधिराज
नाग्नजित->नग्नजित
नाचीन->नचीन
नाटित->नटित
नडस->नडश
नाडायन->नडायन
नाथ्->नत्
नादि->नदी
नाद्य->नद्य
नाध्->नध्
नादित->नधित
नाधीत->नधित
ननान्दर्->ननन्दर्
नान्दी->नन्दी
नान्दिक->नन्दीक
नान्दीक->नन्दीक
नभस्->नभश्
नाभि->नभि
नामक->नमक
नमात्र->नमत्र
नामक->नमाक
नाम्ब->नम्ब
नरकेसरिन्->नरकेशरिन्
नारसिंह->नरसिम्ह
नारिष्ट->नरिष्ट
नारिष्ठ->नरिष्ट
नारीष्ठ->नरिष्ट
नारि->नरी
नार्कुट->नर्कुट
नर्तू->नर्तु
नर्मरा->नर्मणा
नलिनी->नलिनि
नालिनी->नलिनि
नालि->नली
नलोपाख्यान->नलोपख्यान
नवज्वार->नवज्वर
नावनीत->नवनीत
नवरात्र->नवरत्र
नवसस्य->नवशस्य
नासिक->नशीक
नाशुक->नशुक
नासा->नसा
नागकेसर->नागकेशर
नागारि->नागरी
नागवीथी->नागवीथि
नाडीपात्र->नाडिपत्र
नारि->नाणी
नान्दी->नान्दि
नाभानेदिष्ठ->नाभानेदिष्ट
नामधेय->नामदेय
नामसारोद्धार->नामसारोद्धर
नामावली->नामावलि
नारद्वासव->नारद्वसव
नारीष्ठ->नारीष्ट
नालकिनी->नालकिनि
नासाछिन्नी->नाशाछिन्नी
नासिका->नाशिका
निःसंशय->निःशंसय
निःसाण->निःसर
निःसार->निःसर
निकारण->निकरण
निकाश->निकस
निखिलार्थ->निखिलर्थ
निगाद्य->निगद्य
निगार->निगर
निगूढक->निगुढक
निगूहन->निगुहन
निधि->निदी
निनादिन्->निनदिन्
निपाक->निपक
निपात्य->निपत्य
निभ->निब
निबिरीस->निबिरीश
निम्लोचनी->निम्लोचनि
निरञ्छन->निरञ्चन
निरापद्->निरपद्
निरायति->निरयति
निराशा->निरसा
निराकाङ्क्ष->निराकङ्क्ष
निरामिषाशिन्->निरामिषशिन्
निरासन->निराशन
निरासित्व->निराशित्व
निरीक्षक->निरिक्षक
निरूष्मन्->निरुष्मन्
निरृथ->निरृत
निर्घात->निर्गत
निर्ज्ञाति->निर्ज्ञति
निर्माद्->निर्मद्
निर्वाच्->निर्वच्
निर्वाञ्च्->निर्वञ्च्
निर्वाणपूरण->निर्वाणपुराण
निर्वीर->निर्विण
नील->निल
नीलाम्भोज->निलाम्भोज
नीवि->निवि
नीवि->निवी
निशठ->निशट
निशाट->निशट
निशादि->निशदि
निशादि->निशधि
निश्रेणी->निश्रेणि
नीषह्->निषह्
निषादकर्षू->निषादकर्षु
निष्कासनीय->निष्काशनीय
निष्ठीव->निष्टीव
निष्ठावन्त्->निष्ठवन्त्
निष्ठीव->निष्ठिव
निष्ठीवन->निष्ठिवन
निष्फलय्->निष्पलाय्
निष्प्रतीकार->निष्प्रतिकार
नील->नीLअ
नीरूप->नीरुप
नीलपृष्ठ->नीलपृष्ट
नृकेसरि->नृकेशरी
नैमिश->नेमिश
नैश->नेश
नैशिक->नेशिक
नैपात्य->नैपथ्य
नैरूहिक->नैरुहिक
नैर्झर->नैर्जर
न्यासिन्->न्यसिन्
पक्वसस्योपमोन्नति->पक्वशस्योपमोन्नति
पक्षाघात->पक्षघात
पचप्रकूटा->पचप्रकुटा
पञ्चाज->पञ्चज
पञ्चपात्र->पञ्चपत्र
पञ्चप्रासाद->पञ्चप्रसाद
पञ्चसस्य->पञ्चशस्य
पञ्चशैरीषक->पञ्चशैरिषक
पञ्चौदन->पञ्चोदन
पटकुटी->पटकुटि
पटीक्षेप->पटिक्षेप
पठि->पटी
पटौर->पटोर
पट्टीश->पट्टिस
परकाल->पणकाल
परता->पणता
परत्व->पणत्व
पणास्थि->पणस्थि
पराधि->पणादि
परायति->पणायति
परार्ध->पणार्ध
पण्याजीव->पण्यजीव
पतितसावित्रीक->पतितसवित्रीक
पतीय्->पतिय्
पतिवती->पतिवति
पत्त्रसिरा->पत्त्रशिरा
पथीन्->पथिन्
पदायत->पदयात
पदष्ठीव->पदष्टीव
पद्मकेसर->पद्मकेशर
पद्मनाभद्वादशी->पद्मनाभद्वदशी
पद्मभास->पद्मभाश
पद्मावती->पद्मवती
पन्नगकेसर->पन्नगकेशर
पयःपारावार->पयःपारावर
पयस्->पयश्
पयोधा->पयोदा
पराजित्->परजित्
पराभव->परभाव
पराभाव->परभाव
परमार->परमर
परमराज->परमरज
परमार्थ->परमार्त
परावृत्->परवृत्
परस्->परश्
परस्व->परश्व
परस्वन्त्->परश्वन्त्
परसंचारक->परसंचरक
पराक्रमकेसरिन्->पराक्रमकेशरिन्
परारि->पराणी
पराप्रासादमन्त्र->पराप्रसादमन्त्र
पाराशर->परासर
परिक्षाण->परिक्षण
परीक्षण->परिक्षण
पारिक्षि->परिक्षी
परिघात->परिगत
पाणिगत->परिगत
पाणिघात->परिगत
पारिजात->परिजात
परीणस्->परिणश्
परित्याजन->परित्यजन
परिपाचन->परिपचन
परिपान->परिपन
परिप्री->परिप्रि
पारिभव्य->परिभाव्य
पारिभाव्य->परिभाव्य
परिभू->परिभु
पाणिभुज्->परिभुज्
परीमन्->परिमन्
पारिमाण्डल्य->परिमाण्डल्य
पाणिमित->परिमित
पाणिमुक्त->परिमुक्त
पाणिमुख->परिमुख
परीणाय->परिरय
परिवार->परिवाण
परीवार->परिवाण
परिवी->परिवि
परिव्राज्->परिव्रज्
पारिव्रज्य->परिव्राज्य
पारिव्राज्य->परिव्राज्य
परिषूति->परिषुति
परिष्कर->परिष्कण
परिष्कार->परिष्कण
परीसर->परिसार
परीसार->परिसार
पारिहास्य->परिहास्य
पाणि->परी
परुःस्रंस->परुःश्रंस
पारुषक->परुषक
पारु->परू
पारुषक->परूषक
परेतावास->परेतवास
पर्णवी->पर्णवि
पाण्य->पर्य
पार्य->पर्य
पर्यान्तम्->पर्यन्तम्
पर्यूषणाष्टाह्निका->पर्युषणाष्टाह्निका
पर्वस->पर्वश
पालक्क->पलक्क
पालाशि->पलाशी
पालिका->पलिका
पाल्वलतीर->पल्वलतीर
पावा->पवा
पाव्य->पव्य
पाश->पश
पास->पश
पशूखा->पशुका
पाशुपाल्य->पशुपाल्य
पशुहरीतकी->पशुहरितकी
पश्चिमानूपक->पश्चिमानुपाक
पष्ठवह्->पष्टवह्
पाश->पस
पास->पस
पाशी->पसि
पांसन->पांशन
पांसव->पांशव
पांसु->पांशु
पांसुकासीस->पांशुकासीस
पांसुकुली->पांशुकुली
पांसुकूल->पांशुकूल
पांसुक्षार->पांशुक्षार
पांसुचत्वर->पांशुचत्वर
पांसुचन्दन->पांशुचन्दन
पांसुचामर->पांशुचामर
पांसुज->पांशुज
पांसुमर्दन->पांशुमर्दन
पांसुर->पांशुर
पांसुरागिणी->पांशुरागिणी
पांसुल->पांशुल
पांसुव->पांशुव
पांसुवर्ष->पांशुवर्ष
पांसुकासीस->पांसुकसीस
पाकारु->पाकरु
पाची->पाचि
पाञ्चाल्य->पाञ्चल्य
पाठा->पाटा
पाठिका->पाटिका
पाटूर->पाटुर
पारक->पाणक
पाणौकरण->पाणोकरण
पाथिक->पातिक
पादपीठ->पादपीट
पादशस्->पादशश्
पादूकृत्->पादुकृत्
पानीयवर्णिका->पानियवर्णिका
पान्नागारि->पान्नगारि
पारापार->पारपार
पारमार्थिक->पारमर्थिक
पारमैश्वर्य->पारमेश्वर्य
पारंपरीण->पारंपरिण
पारस->पारश
पाराशर्य->पारशर्य
पाराशर्यायण->पारशर्यायण
पारसिक->पारशीक
पारसीक->पारशीक
पारसीप्रकाश->पारशीप्रकाश
पारावार->पारावर
पारिकार्मिक->पारिकर्मिक
पारिमाण्डल्य->पारिमण्डल्य
पार्श्वैकादशी->पार्श्वेकादशी
पालाशक->पालशक
पालहारि->पालहरि
पालिन्धी->पालिन्दी
पाशुपाल्य->पाशुपल्य
पाहात->पाहत
पिच्छ->पिच्च
पिठक->पिटाक
पीठक->पिटाक
पीठ->पिठ
पीड्->पिड्
पीड->पिड
पीडा->पिडा
पीड->पिढ
पिण्डारक->पिण्डरक
पिण्डस->पिण्डश
पिण्डाश->पिण्डश
पितुभाज्->पितुभज्
पितृरूप->पितृरुप
पितृहू->पितृहु
पित्तातीसार->पित्तातिसार
पिप्पलू->पिप्पलु
पिलुपर्णी->पिलुपर्णि
पिष्टपूर->पिष्टपुर
पीथि->पीती
पुंस्->पुंश्
पुच्छटी->पुच्छटि
पुच्छाण्डक->पुच्छण्डक
पुञ्जील->पुञ्जिल
पुटी->पुटि
पुर->पुण
पूर->पुण
पूरक->पुणक
पुरिका->पुणिका
पूतिसृञ्जय->पुतीसृञ्जय
पुत्रपौत्र->पुत्रपोत्र
पुत्रान्नाद->पुत्रान्नद
पूत->पुथ
पूति->पुथि
पुनरुपागम->पुनरुपगम
पुनर्भार्या->पुनर्भर्या
पुप्फुस->पुप्पुस
पूरक->पुरक
पूरम्->पुरम्
पुरवासिन्->पुरवसिन्
पुरस्->पुरश्
पुराहित->पुरहित
पुरीषाधान->पुरीषधान
पुरूतम->पुरुतम
पुरूरवस्->पुरुरवस्
पुरूवसु->पुरुवसु
पुरुशाक->पुरुशक
पुरुषकेसरिन्->पुरुषकेशरिन्
पूरुषघ्न->पुरुषघ्न
पुरुषांसक->पुरुषांशक
पूरु->पुरू
पुरोधस्->पुरोदास्
पूर्व्->पुर्व्
पूर्व->पुर्व
पुलीका->पुलिका
पूषर्य->पुषर्य
पुष्करसाद->पुष्करसद
पुष्कस->पुष्कश
पुष्पकासीस->पुष्पकासीश
पूय्->पूञ्
पूर->पूण
पूतीकरञ्ज->पूतिकरञ्ज
पूथिका->पूतिका
पूतिसृञ्जय->पूतिशृञ्जय
पूथिका->पूतीका
पूर्वातिथि->पूर्वतिथि
पूर्वभाज्->पूर्वभज्
पूर्वाभाद्रपदा->पूर्वभद्रपदा
पूर्वभाव->पूर्वभव
पूर्वाभाद्रपदा->पूर्वभाद्रपदा
पूर्वसक्थ->पूर्वशक्थ
पृथुश्रवस्->पृतुश्रवस्
पृष्ठज->पृष्टज
पैञ्जूष->पेञ्जूष
पैठिक->पेटिक
पैठकलायन->पैटकलायन
पैठीनसि->पैठिनसि
पोथकि->पोतकी
पौतिक->पोथिक
पौलि->पोली
पौरुषांसकिन्->पौरुषांशकिन्
पौरोधस->पौरोदाश
पौरोभाग्य->पौरोबाग्य
पौष्टी->पौष्टि
प्रकाशेतर->प्रकशेतर
प्रखल->प्रकाल
प्रगाथ->प्रगत
प्रघात->प्रगत
प्रचारित->प्रचरित
प्रणी->प्रणि
प्रतान्->प्रतन्
प्रताम्->प्रतम्
प्रतमाम्->प्रतमम्
प्रतापनारसिंह->प्रतापनारशिंह
प्रतिकारिन्->प्रतिकरिन्
प्रतिथि->प्रतिती
प्रतिधा->प्रतिदा
प्रतिपादम्->प्रतिपदम्
प्रतिपूरुषम्->प्रतिपुरुषम्
प्रतिप्राश्->प्रतिप्रश्
प्रतिभ->प्रतिब
प्रतिबाधक->प्रतिबधक
प्रतिभी->प्रतिबि
प्रतियोगिज्ञानकारणतावाद->प्रतियोगिज्ञानकरणतावाद
प्रतिरथ->प्रतिरत
प्रतिवाच्->प्रतिवच्
प्रतिस्याय->प्रतिश्याय
प्रतिष्ठान->प्रतिष्ठन
प्रातिष्ठित->प्रतिष्ठित
प्रतिसामन्त->प्रतिसमन्त
प्रतीसारम्->प्रतिसारम्
प्रातिहत->प्रतिहत
प्रतिहार->प्रतिहर
प्रतीहार->प्रतिहर
प्रातिहार->प्रतिहर
प्राति->प्रती
प्रतीची->प्रतीचि
प्रथिष्ठ->प्रतीष्ट
प्रतोली->प्रतोलि
प्रात्यवेक्षा->प्रत्यवेक्षा
प्रत्याश्राव->प्रत्यश्रव
प्रत्याघात->प्रत्यागत
प्रत्युद्घात->प्रत्युद्गत
प्रत्यूषस्->प्रत्युषस्
प्रथमभाज्->प्रथमभज्
प्रथिवी->प्रथिवि
प्रथिष्ठ->प्रथिष्ट
प्रदाम्->प्रदम्
प्रदाव->प्रदव
प्रधारण->प्रदारण
प्रधि->प्रदी
प्रधी->प्रदी
प्रदेशिनी->प्रदेशिनि
प्राद्योति->प्रद्योति
प्राध्वन->प्रध्वान
प्रापणीय->प्रपाणीय
प्रभु->प्रबू
प्रभू->प्रबू
प्रभाज्->प्रभज्
प्रभृथ->प्रभृत
प्राभृत->प्रभृत
प्रमर->प्रमण
प्रमाण->प्रमण
प्रमार->प्रमण
प्रमथ->प्रमत
प्रमाथ->प्रमत
प्रामति->प्रमती
प्रामति->प्रमथि
प्रमाथिन्->प्रमथिन्
प्रामति->प्रमाथी
प्रामाद्य->प्रमाद्य
प्रमी->प्रमि
प्रमीय->प्रमिय
प्रयात->प्रयत
प्रायु->प्रयु
प्रायोक्त्र->प्रयोक्त्र
प्राणथ->प्ररथ
प्ररूढ->प्ररुढ
प्रलम्भ->प्रलंब
प्रालम्ब->प्रलंब
प्रलयाकल->प्रलयकाल
प्रवाच्->प्रवच्
प्रवाद्य->प्रवध्य
प्रावन्->प्रवन्
प्रवर्धक->प्रवर्दक
प्रावहणि->प्रवहणी
प्रावाहणि->प्रवहणी
प्रावणि->प्रवाणी
प्रावहणि->प्रवाहणी
प्रावाहणि->प्रवाहणी
प्रावी->प्रवि
प्रावी->प्रवी
प्रावृत->प्रवृत
प्रावृष्->प्रवृष्
प्रव्याहार->प्रव्यहार
प्रव्राज्->प्रव्रज्
प्राव्रज्य->प्रव्राज्य
प्राव्राज्य->प्रव्राज्य
प्रस्->प्रश्
प्राश्->प्रश्
प्रशंसन->प्रशंशन
प्रशंसा->प्रशंशा
प्रशाख->प्रशक
प्राशक->प्रशक
प्रासक->प्रशक
प्रसक्ति->प्रशक्ति
प्रसाद्->प्रशद्
प्रशाम्->प्रशम्
प्रसामि->प्रशमी
प्रशासन->प्रशसन
प्रशासितर्->प्रशसितर्
प्रसित->प्रशित
प्राशित->प्रशित
प्रसित->प्रशीत
प्राशित->प्रशीत
प्रसून->प्रशून
प्रष्ठिवाहिन्->प्रष्टिवाहिन्
प्राश->प्रस
प्रास->प्रस
प्रासङ्ग->प्रसङ्घ
प्रसाद्->प्रसद्
प्रासह्->प्रसाह्
प्रसू->प्रसु
प्राशु->प्रसु
प्राशू->प्रसु
प्रास्ताविक->प्रस्ताविक
प्रास्तावि->प्रस्थावि
प्रहाणि->प्रहणि
प्राहणि->प्रहणि
प्राहरिक->प्रहणीक
प्राहारिक->प्रहणीक
प्रहरणीय->प्रहरणिय
प्रहाणि->प्रहरी
प्राहणि->प्रहरी
प्राहणि->प्रहारि
प्रह्वाय->प्रह्वय
प्राग्भावीय->प्राग्भवीय
प्राछ्->प्राच्
प्राणनाथ->प्राणनथ
प्राणहीन->प्राणहिन
प्रातिहार->प्रातिहर
प्राधा->प्रादा
प्रायस्->प्रायश्
प्रासह्->प्राशः
प्रासह्->प्रासः
प्रीत->प्रिथ
प्रियभाषिन्->प्रियभषिन्
प्रियालापिन्->प्रियलापिन्
प्रियवाद->प्रियवद
प्रियालापिन्->प्रियालपिन्
प्रेमावती->प्रेमवती
प्रैण्->प्रेर्
प्रैषणिक->प्रेषणिक
प्रेष्ठ->प्रेष्ट
प्रेष्यात्व->प्रेष्यत्व
प्रेहिवाणिजा->प्रेहिवणिजा
प्रौक्त->प्रोक्त
प्रौढ->प्रोढ
प्रौढपाद->प्रोढपाद
प्रौढि->प्रोढि
प्रोन्माथिन्->प्रोन्मथिन्
प्लक्षप्रस्रवण->प्लक्षप्रश्रवण
प्लीहा->प्लिहा
फञ्जी->फञ्जि
फणिकेसर->फणिकेशर
फारिव->फरिव
फलकेसर->फलकेशर
फलस->फलश
फाल्गुनि->फल्गुनि
फाल्गुनि->फल्गुनी
बह्->बः
भङ्ग->बङ्ग
भट्ट->बट्ट
भट्टस्वामिन्->बट्टस्वामिन्
भट्->बठ्
भट->बठ
बाड्->बड्
भण्->बण्
भर्->बण्
बर->बण
बाण->बण
बार->बण
भण->बण
भर->बण
भण्ट्->बण्ट्
बाध->बद
बादक्सान->बदक्सान
बादरि->बदरि
बादरि->बदरी
बाध->बध
बाधक->बधक
भदाक->बधक
भद्र->बध्र
बाध्व->बध्व
भन्->बन्
बान्धकि->बन्धकी
बान्धकि->बन्धाकि
बाभ्रव->बभ्रव
भम्भ->बम्ब
भम्भराली->बम्भराली
भम्भराली->बंभराली
भरट->बरट
भरम->बरम
भर्भरा->बर्बणा
भर्भरा->बर्बरा
बर्बरीक->बर्बरिक
भर्व्->बर्व्
बलाक->बलक
बालक->बलक
बलाकाश्व->बलकाश्व
बालचन्द्र->बलचन्द्र
बलाय्->बलय्
बलाय->बलय
बलवीर्य->बलविर्य
बालशर्मन्->बलशर्मन्
बालाकि->बलाकि
बालानुचरगुप्त->बलानुचरगुप्त
बलास->बलाश
बलीन->बलिन
बालिमन्->बलिमान्
बालिश->बलिश
बालीश->बलिश
बलीह->बलिह
बालीवर्दिनेय->बलीवर्दिनेय
भल्लवि->बल्लवी
भल्लुक->बल्लुक
भल्लूक->बल्लुक
भष्->बष्
भस्->बस्
बस्तवासिन्->बस्तवाशिन्
बाह->बह
बाहव->बहव
बाहदुर->बहादुर
बाहादुर->बहादुर
बहिस्->बहिश्
बहुतन्त्री->बहुतन्त्रि
बहुतराम्->बहुतरम्
बाहुदन्तक->बहुदन्तक
बहुधार->बहुधर
बहुपाय्य->बहुपय्य
बहुलौषधिक->बहुलौषदिक
बहुविधाकार->बहुविधाकर
बह्वजाविक->बह्वजविक
भा->बा
बाजबाहादुरचन्द्र->बाजबहादुरचन्द्र
बाढ->बाड
भड->बाड
भडित->बाडित
भरस्->बाणस्
बाणासन->बाणसन
भरणि->बाणारि
भरि->बाणि
भरिणी->बाणिणी
भरि->बाणी
बाध्यौगायन->बाध्योगायन
बालोपचरणीय->बालोपचरणिय
भव->बाव
बावाशास्त्रिन्->बावाशस्त्रिन्
बाष्पीका->बाष्पिका
बाहीक->बाहिक
बीजकोश->बिजकोश
बिठ->बिट
बुध->बुद
बूष->बुष
बृसी->बृशी
बृहत्सामन्->बृहत्समन्
बृहद्ग्रावन्->बृहद्ग्रवन्
बृहद्ध्वनी->बृहद्ध्वनि
बृहद्भानु->बृहद्बानु
बैजवापायन->बैजवापयन
ब्राह्मण->ब्रह्मण
ब्राह्मणसात्->ब्रह्मणसात्
ब्राह्मलौकिक->ब्रह्मलौकिक
ब्रह्मवध्या->ब्रह्मवद्या
ब्राह्मणी->ब्राह्मणि
ब्राह्माणी->ब्राह्मणि
भाकुट->भकूट
भाकूट->भकूट
भगास्य->भगस्य
भागलि->भगाली
भट्टारक->भट्टरक
भद्रकार->भद्रकर
भद्रपीठ->भद्रपिठ
भद्रपीठ->भद्रपीट
भद्रवाच्->भद्रवच्
भद्रावती->भद्रवती
भद्रावह->भद्रवाह
भद्रशाख->भद्रशाक
भद्रौदनी->भद्रोदनी
भम्भासार->भम्भसार
भरद्वाज->भरद्वज
भर्म्याश्व->भर्म्यश्व
भवभावन->भवभवन
भवासर->भवसार
भस्मसात्->भस्मसत्
भागध->भागद
भागीरथ->भागिरथ
भानुजीदीक्षित->भानुजिदीक्षित
भारवाह->भारवह
भारीट->भारिट
भारूप->भारुप
भाष्यकार->भाष्यकर
भीरु->भिरु
भीरुकच्छ->भिरुकच्छ
भूरमण->भुरमाण
भूरिज->भुरिज
भूर्ज->भुर्ज
भूवह्->भुवः
भूशुण्डी->भुशुण्डी
भूसुर->भुसुर
भूखण्ड->भूकाण्ड
भूतवाहनसारथि->भूतवाहनसरथि
भूपाटली->भूपाटलि
भृङ्गारीट->भृङ्गरिट
भृङ्गारीट->भृङ्गरीट
भृङ्गार->भृङ्गाण
भृङ्गाली->भृङ्गालि
भृङ्गीरिटि->भृङ्गिरिटि
भृङ्गीरिटि->भृङ्गिरीटि
भृशी->भृशि
भोगावती->भोगवती
भोगावली->भोगावलि
भोगीन्द्र->भोगिन्द्र
भौरिक्या->भौणिक्या
भौली->भौलि
भ्राजि->भ्रजि
भ्राजिष्ठ->भ्रजिष्ठ
भ्रातृभार्या->भ्रतृभार्या
भ्रान्तिमन्त्->भ्रन्तिमन्त्
भ्रमरविलसित->भ्रमणविलसित
भ्रमत्कुटी->भ्रमत्कुटि
भ्राष्ट्रज->भ्रष्ट्रज
भ्राश्य->भ्रस्य
भ्रू->भ्रु
भ्रूकुंश->भ्रुकुंस
भ्रुकुटीमुख->भ्रुकुटिमुख
भ्रूकुटीमुख->भ्रुकुटिमुख
भ्रूकुटि->भ्रुकुटी
भ्लास्->भ्लाश्
मकुष्ठक->मकुष्टक
मक्षीका->मक्षिका
मङ्ख->मङ्क
मङ्गलादेशवृत्त->मङ्गलदेशवृत्त
मङ्गलाव्रत->मङ्गलव्रत
मञ्जरीनम्र->मञ्जरिनम्र
मञ्जुभाषिन्->मञ्जुभषिन्
मठ->मट
मठोशीलोठिका->मठोशिलोठिका
मडार->मडर
मणीचक->मणिचक
मणिपाली->मणिपालि
मणिमन्थ->मणिमन्त
मणीवक->मणिवक
मणिसर->मणिशर
मणिसार->मणिशर
मथा->मता
मथ्र->मत्र
मथूरा->मथुरा
मधुमथ्->मधुमत्
मधुमल्ली->मधुमल्लि
मधुश्रेणी->मधुश्रेणि
मध्वर्णस्->मध्वर्णश्
मनःसुख->मनःशूक
मनस्->मनश्
मनुष्यरूप->मनुष्यरुप
मनोरथ->मनोरत
मनोहारी->मनोहरी
मनोहारी->मनोहारि
मन्था->मन्ता
मारद->मरध
मरी->मरि
मारि->मरि
मारिन्->मरिन्
मारीचि->मरीची
मारीचि->मरीछि
मार्ग->मर्ग
मार्गणक->मर्गरक
मर्जू->मर्जु
मार्जक->मर्झक
मर्मरी->मर्मरि
मार्ष्टि->मर्ष्टि
मलपू->मलपु
मालव->मलव
मालाकर->मलाकार
मालाकार->मलाकार
मालावन्त्->मलावन्त्
मालि->मलि
मालित->मलित
मालिन्य->मलिन्य
मालोपमा->मलोपमा
मसन->मशन
मासन->मशन
मसक->मशाक
मासक->मशाक
मसि->मशि
मसी->मशि
मसि->मशी
मसी->मशी
माष->मष
माषतिल->मषतिल
मासुरी->मसूरी
महाद्भुत->महद्भूत
महान्तक->महन्तक
महावराह->महवराह
महावाराह->महवराह
महाकारण->महाकरण
महाकरुणाचन्द्रि->महाकरुणचन्द्रि
महाकर्कारु->महाकर्करु
महाघोष->महागोष
महागौरी->महागौरि
महाधनिक->महादानिक
माहन->महान
महापार->महापण
महापात्र->महापत्र
महाप्रतीहार->महाप्रतिहार
महाबाहु->महाबहु
महाभार->महाभर
महामान्दार->महामन्दर
महामाया->महामया
महामेधा->महामेदा
महारौद्र->महारोद्र
महालीलासरस्वती->महालीलसरस्वती
माहाव्रती->महाव्रती
महाशङ्ख->महाशङ्क
महासुर->महाशूर
महीपति->महिपति
माहिष्मती->महिष्मति
माहिष्मती->महिष्मती
माहीयत्व->महीयत्व
माहेन्द्रवाणी->महेन्द्रवाणी
माहेश्वरपद->महेश्वरपद
महोत्साह->महोत्सह
मांसपेशी->मांसपेशि
माक्षिकाशर्करा->माक्षिकशर्करा
माक्षीकशर्करा->माक्षिकशर्करा
माञ्जिष्ठ->माञ्जिष्ट
माठी->माटि
मारि->माणि
माणिमन्थ->माणिमन्त
माण्डूक->माण्डुक
माण्डूकि->माण्डुकि
माण्डूकेय->माण्डुकेय
माधवाश्रम->माधवश्रम
माधवाचार्य->माधवाचर्य
माधुर्यकादम्बिनी->माधुर्यकदम्बिनी
मानायन->मानयान
मानार्ह->मानर्ह
मानीन्ध->मानिन्ध
मान्थ्य->मान्त्य
मारारि->मारणी
मार्कण्डेयकवीन्द्र->मार्कण्डेयकविन्द्र
मार्जालीय->मार्जलीय
मालाका->मालका
मालकौश->मालकोश
मालाकण्ठ->मालाकण्ट
माषी->माषि
मासुरी->मासुरि
मीलित->मिलित
मीव्->मिव्
मिसि->मिशी
मिसरूमिश्र->मिसरुमिश्र
मुह्->मुः
मुख->मुक
मूक->मुक
मुकुष्ठक->मुकुष्टक
मुक्तापुष्प->मुक्तपुष्प
मुखाम्बुज->मुखम्बुज
मुञ्जातक->मुञ्जताक
मूटक->मुटक
मूट->मुठ
मूढ->मुड
मुर->मुण
मूर->मुण
मूतिब->मुतिब
मूत->मुथ
मुधा->मुदा
मुराद->मुरद
मूर्छा->मुर्छा
मूल->मुल
मुसल->मुशल
मुसली->मुशली
मुष्कभार->मुष्कभर
मुष्कशून्य->मुष्कशुन्य
मुष्टीमुष्टि->मुष्टिमुष्टि
मूलकेसर->मूलकेशर
मूली->मूलि
मृगजीवन->मृगजिवन
मृगार->मृगण
मृणालवन्त्->मृणलवन्त्
मृतधार->मृतदार
मृतपूरुषदेह->मृतपुरुषदेह
मृत्कांस्य->मृत्कांश्य
मृध->मृद
मेघाय्->मेघय्
मेघयाति->मेघयति
मेघराजी->मेघराजि
मेठ->मेट
मेठि->मेटी
मेढ->मेड
मेढ्र->मेड्र
मेढी->मेढि
मैत्रायणीयोपनिषद्->मेत्रायणीयोपनिषद्
मैत्रावरुण->मेत्रावरुण
मेदपाठ->मेदपाट
मेदस्->मेदश्
मेधस्->मेदश्
मेधा->मेदा
मेधस->मेदाश
मेधि->मेदी
मेधाजित्->मेधजित्
मेधाकार->मेधाकर
मेनाजा->मेनजा
मेषविषाणिका->मेषविषणिका
मेषाक्षीकुसुम->मेषाक्षिकुसुम
मैत्रीभाव->मैत्रिभाव
मोरक->मोणक
मोराक->मोणक
मोदाकि->मोदकी
मौदक->मोदाक
मौसल->मौशल
म्रदिष्ठ->म्रदिष्ट
यछ्->यच्
याच्->यच्
यज्ञवल्ली->यज्ञवल्लि
यज्ञवाह->यज्ञवह
याज्ञसेनि->यज्ञसेनि
यातन->यतन
यातन->यतान
यतिथ->यतित
याति->यती
यात्रा->यत्रा
यात->यथ
याथ->यथ
याथाकथाच->यथाकथाच
याथाकामी->यथाकामी
यथाख्यात->यथाख्यत
यथावासम्->यथावशम्
यथोपपादम्->यथोपपदम्
यादृच्छिक->यदृच्छिक
याभ->यभ
यामरथ->यमरथ
यामि->यमी
यामी->यमी
ययाति->ययति
यविष्ठ->यविष्ट
यशस्->यशश्
यशोमती->यशोमति
याष्टीक->यष्टीक
यास->यस
याशु->यसु
याच्छ्रेष्ठ->याच्छ्रेष्ट
यायावर->यायवर
याष्टीक->याष्टिक
यून्->युङ्
युध्->युद्
युद्ध->युद्द
यूप->युप
यूष->युष
यौगक->योगक
यौगिक->योगिक
यौन->योन
रक्तकेसर->रक्तकेशर
रक्तवरटी->रक्तवरटि
रक्तस्राव->रक्तश्रव
रक्तस्राव->रक्तश्राव
रक्षोवाह->रक्षोवह
रजनीजल->रजनिजल
रजनीपति->रजनिपति
रजनीमुख->रजनिमुख
रजाशय->रजसय
रतू->रतु
रत्नावती->रत्नवती
रथघोष->रथगोष
रथपाद->रथपद
रथसप्तमी->रथसप्तमि
रथी->रथि
राति->रथि
राधि->रदि
राधि->रदी
राद्ध->रद्ध
राध->रध
रान्धस->रन्धस
रभ्->रब्
रभ->रब
रभि->रबि
रामणि->रमणी
रामल->रमल
रामण->रमाण
रामेश्वर->रमेश्वर
रामोद->रमोद
राम्या->रम्या
रर्फ्->रर्प्
रावण->रवाण
रावित->रवित
रस्->रश्
राश्->रश्
रास्->रश्
रस->रश
रास->रश
रसन->रशन
रासन->रशन
रस्य->रश्य
रास्य->रश्य
रास्ना->रस्ना
रही->रहि
राजकसेरु->राजकशेरु
राजादन->राजदन
राजादन->राजधन
राजादन->राजधान
राजाधीन->राजधीन
राजानक->राजनक
राजमण्डूक->राजमण्डुक
राजावर्त->राजवर्त
राजवीथी->राजविथी
राजासन->राजशन
राजसुख->राजशूक
राठ->राट
रारा->राणा
राथीतर->राथितर
रास->राश
रिक्थाद->रिक्ताद
रीव्->रिव्
रुह्->रुः
रुध->रुद
रुधिरामय->रुधिरमय
रूपक->रुपक
रूपगोस्वामिन्->रुपगोस्वामिन्
रूप्यक->रुप्यक
रूवुक->रुवुक
रूवुक->रुवूक
रूपायुधभृत्->रूपयुधभृत्
रैणव->रेणव
रेणुरूषित->रेणुरुषित
रेभ्->रेब्
रेभ->रेब
रैभ->रेब
रैभ्य->रेभ्य
रौट्->रोट्
रोमकेसर->रोमकेशर
रोमन्थाय्->रोमन्थय्
रोमविध्वंस->रोमविध्वंश
रोमावली->रोमावलि
रोहिताश्व->रोहितश्व
रौमशीय->रौमशिय
लाक्षा->लक्षा
लक्ष्मीफल->लक्ष्मीपल
लाघ्->लघ्
लघिष्ठ->लघिष्ट
लघूकरण->लघुकरण
लङ्घन->लङ्गन
लाङ्गलि->लङ्गली
लाज->लज
लाड->लड
लाडि->लडि
लभ्->लब्
लाभ्->लब्
लम्भ्->लंब्
लम्भ->लंब
लम्बोष्ठ->लम्बोष्ट
लालक->ललाक
लालाटि->ललाटी
ललीतिका->ललितिका
लवणाकर->लवणकर
लवणखानि->लवणखनि
लावम्->लवम्
लावानक->लवानक
लस->लश
लास->लश
लसीका->लसिका
लस्पूजनी->लस्पूजनि
लाटानुप्रास->लाटानुप्राश
लिह्->लिः
लिगी->लिगि
लिम्पाक->लिम्पक
लीला->लिला
लीलाकमल->लिलाकमल
लीलागार->लिलागार
लीलाय्->लिलाय्
लीलावापी->लिलावापी
लुण्ठ->लुण्ट
लुण्ठन->लुण्टन
लूता->लुता
लूत->लुथ
लुभ्->लुब्
लुम्बी->लुम्बि
लूष->लुष
लूह->लुह
लेखाभ्रू->लेखाभ्रु
लोकचारित्र->लोकचरित्र
लोभायन->लोभयान
लोहाकर्ण->लोहकर्ण
लौहकारि->लोहकारी
लौहचारक->लोहचारक
लौहशास्त्र->लोहशास्त्र
लौहितीक->लोहितीक
लौहि->लोही
लौहेयी->लोहेयी
लौहितीक->लौहितिक
वंसग->वंशग
वंशधारा->वंशधरा
वह्->वः
वाक->वक
वक्रपाद->वक्रपद
वक्षस्->वक्षश्
वक्षी->वक्षि
वाक->वख
वागु->वगु
वाचा->वचा
वच्छल->वच्चल
वाज->वज
वाजसनेयक->वजसनेयक
वज्राकर->वज्रकण
वज्राकार->वज्रकण
वज्रपातन->वज्रपतन
वज्रवाराही->वज्रवराही
वज्री->वज्रि
वाटु->वटु
वटूरिन्->वटुरिन्
वाट->वठ
वारिन्->वणिङ्
वात->वत
वात्सीपुत्रीय->वत्सीपुत्रीय
वादनक->वदनक
वाधुल->वदुल
वाधूल->वदुल
वादवाद->वधावध
वादिर->वधिर
वाद्यमान->वध्यमान
वनकण्डूल->वनकण्डुल
वनपांसुल->वनपांशुल
वनभोजनपुण्याहवाचनप्रयोग->वनभोजनपुण्याहवचनप्रयोग
वानराष्टक->वनराष्टक
वाना->वना
वानीय->वनीय
वाङ्ग->वन्ग
वन्ध्यत्व->वन्द्यत्व
वन्ध्यात्व->वन्द्यत्व
वान्या->वन्या
वापनि->वपनी
वापीह->वपीह
वमनीया->वमनिया
वामनी->वमनी
वामनीय->वमनीय
वामी->वमी
वायन->वयन
वायक->वयाक
वायोधस->वयोधस
वरणस्रज्->वरणश्रज्
वरादन->वरधान
वारधान->वरधान
वारनारी->वरनारी
वरमुखी->वरमुकी
वराय्->वरय्
वारयुवति->वरयुवती
वराण->वरर
वारण->वरर
वारला->वरला
वरालि->वरली
वारवारण->वरवारण
वराहक->वरहक
वाराहक->वरहक
वाराटकि->वराटकि
वाणरसी->वराणसी
वाणारसी->वराणसी
वाराणसी->वराणसी
वारला->वराला
वाराहकर्णी->वराहकर्णी
वरी->वरि
वाणि->वरि
वाणी->वरि
वारि->वरि
वारी->वरि
वरीतर्->वरितर्
वारिन्->वरिन्
वरुणग्राह->वरुणग्रह
वारुणोपपुराण->वरुणोपपुराण
वरूत्रि->वरुत्री
वर्णपात्र->वर्णपत्र
वार्त्त->वर्त्त
वार्त्ताक->वर्त्तक
वार्त्तिक->वर्त्तिक
वार्द्ध->वर्द्ध
वार्द्धक->वर्द्धक
वार्धनी->वर्धनी
वर्धाय->वर्धय
वर्धिनी->वर्धिनि
वार्वट->वर्वट
वर्वूर->वर्वुर
वर्षयन्ती->वर्षयन्ति
वार्षसहस्रिक->वर्षसहस्रिक
वालधि->वलदी
वालक->वलाक
वालन->वलान
वल्गुली->वल्गुलि
वल्मी->वल्मि
वल्मीकि->वल्मिकि
वाल्मिकि->वल्मिकि
वाल्मीकि->वल्मिकि
वल्लारी->वल्लरी
वाव->वव
वसिष्ठ->वशिष्ठ
वसीयंस्->वशीयंस्
वसतीवरी->वसतिवरी
वसाति->वसती
वसतीवरी->वसतीवरि
वसावि->वसवि
वसुधार->वसुधर
वस्तूकी->वस्तुकी
वागुरि->वागुणि
वाग्याम->वाग्यम
वाचाल->वाचल
वाच्यार्थ->वाच्यर्थ
वाजप्रसूत->वाजप्रसुत
वाजसनेयिप्रातिशाख्य->वाजसनेयिप्रातिशख्य
वाञ्छाक->वाञ्छक
वाटीदीर्घ->वाटिदीर्घ
वारबाण->वाणबार
वारवाण->वाणवार
वारासन->वाणासन
वारिन्->वाणिन्
वारिनाथ->वाणीनाथ
वातायन->वातयान
वातापिसूदन->वातापिसुदन
वातोपसृष्ट->वातोपशृष्ट
वाद्यभाण्ड->वाद्यभण्ड
वारणकेसर->वारणकेशर
वाराणसी->वारणसी
वाराणसी->वारणासी
वार्त्तायन->वार्त्तयन
वालावितु->वालवितु
वासा->वाशा
वासुरा->वाशुरा
वाहूक->वाहुक
वाह्याली->वाह्यालि
वाह्लीक->वाह्लिक
विकार्य->विकर्य
विख्र->विक्र
विक्रमकेसरिन्->विक्रमकेशरिन्
विक्षर->विक्षण
विक्षार->विक्षण
विक्षीर->विक्षीण
विघात->विगत
विगाथा->विगता
विङ्ख->विङ्क
विचित्वारा->विचित्वरा
विजयादशमी->विजयदशमी
विज्जाका->विज्जका
विज्जूलिका->विज्जुलिका
वितस्तापुरी->वितस्तपुरी
वित्तध->वित्तद
विधस्->विदस्
विधस्->विदाश्
विधुरता->विदुरता
विधूरता->विदुरता
विधुरता->विदूरता
विधूरता->विदूरता
विधुरित->विदूरित
विध्यलंकार->विद्यालंकार
विधूत->विधुत
विनासादशन->विनासदशन
विफ->विप
विफलय्->विपलाय्
विपस्->विपश्
विपाश्->विपश्
विपाशिन्->विपशिन्
विपासा->विपाशा
विपुलास्रवा->विपुलाश्रवा
विबाध->विबध
विभ्रु->विब्रू
विभाज्->विभज्
विभाजन->विभजन
विमान->विमन
विमही->विमहि
विमृध्->विमृद्
विराजन->विरजन
विराट->विरट
विरथ->विरत
विरूक्ष->विरुक्ष
विरूक्षण->विरुक्षण
विरूढ->विरुढ
विरूप->विरुप
विरूपक->विरुपक
विरूपय्->विरुपय्
विरूपाक्ष->विरुपाक्ष
विलङ्घित->विलङ्गित
विलास->विलस
विवाच्->विवच्
विविध->विविद
विशाखल->विशकल
विशाल->विशल
विशालीय->विशालिय
विशीत->विशित
विशिष्टी->विशिष्टि
विशून्य->विशुन्य
विशृङ्खल->विशृङ्कल
विश्वतस्->विश्वतश्
विश्वान्तर->विश्वन्तर
विश्वरूप->विश्वरुप
विश्वावसु->विश्ववसु
विश्वशंभू->विश्वशम्भु
विश्वासन->विश्वसन
विश्वस्था->विश्वस्ता
विश्वास्य->विश्वस्य
विश्वाहा->विश्वहा
विश्वाची->विश्वाचि
विश्वासह्->विश्वासः
विषाग्नि->विषघ्नी
विषाण->विषण
विषार->विषण
विषाद्->विषद्
विषयाज्ञान->विषयज्ञान
विषयी->विषयि
विषारि->विषाणी
विषूचि->विषुचि
विषूची->विषुचि
विषौषधी->विषोषधी
विष्कन्ध->विष्कन्द
विष्ठल->विष्टल
विष्ठा->विष्टा
विष्ठाभू->विष्टाभू
विष्णापू->विष्णापु
विष्वाच्->विष्वच्
वीश->विस
वीस->विस
विस्तारण->विस्तरण
विहार->विहाण
वीखा->वीका
वीरकेसरिन्->वीरकेशरिन्
वीरमती->वीरमति
वूस्->वुस्
वृक्षाधिरूढक->वृक्षादिरूढक
वृषाकपायी->वृषकपायी
वृषामोदिनी->वृषमोदिनी
वृषाय्->वृषय्
वृषी->वृषि
वैकटिक->वेकटिक
वैङ्गि->वेङ्गी
वेढमिका->वेडमिका
वेणीस्कन्ध->वेणिस्कन्ध
वेणीस्कन्ध->वेणीस्कन्द
वैतालीय->वेतालीय
वेत्रावती->वेत्रवती
वेधमुख्य->वेदमुख्य
वैदायन->वेदयान
वैदायन->वेदायन
वेधित->वेदित
वैदिक->वेदीक
वैद्युत->वेद्युत
वैदि->वेधी
वैदुर्य->वेधुर्य
वैदूर्य->वेधुर्य
वैधुर्य->वेधुर्य
वैराम->वेरम
वैरि->वेरि
वैरी->वेरि
वेलाकूल->वेलाकुल
वेस्->वेश्
वैश्यपुत्र->वेश्यापुत्र
वैश्यापुत्र->वेश्यापुत्र
वैजान->वैजन
वैरि->वैणि
वैरी->वैणि
वैदेहीबन्धु->वैदेहिबन्धु
वैयाघ्र->वैयग्र
वैरागिक->वैरगिक
वैरागी->वैरागि
वोढर्->वोडर्
वोरपट्टी->वोरपट्टि
वोल्लाह->वोल्लह
व्यंसक->व्यंशक
व्यथ्->व्यत्
व्यथि->व्यती
व्यथित->व्यतीत
व्यथ्ययः->व्यत्ययः
व्यध्->व्यद्
व्यादित->व्यधित
व्याधित->व्यधित
व्ययी->व्ययि
व्यवधा->व्यवदा
व्यस्->व्यश्
व्यापाद->व्यापद
व्यापीत->व्यापित
व्याली->व्यालि
व्यूति->व्युति
व्योमपाद->व्योमपद
व्राजपति->व्रजपति
व्रातीन->व्रतीन
व्रैह->व्रेह
शांशप->शंसप
शाकरी->शकरि
शाकनिका->शकानिका
शाकरी->शकारि
शाकी->शकि
शाखि->शकि
शाकिन->शकिन
शाकुनि->शकुनी
शाकुन्तल->शकुन्तल
शाकोट->शकोट
शाखोट->शकोट
शङ्खण->शङ्कर
शांकरि->शंकरी
शङ्खोद्धार->शङ्कोद्धार
शांकर->शंखण
शाटि->शटी
शाठी->शटी
शठाम्बा->शठम्बा
शाटि->शठी
शाठी->शठी
शाड्->शड्
शढी->शडि
शातकौम्भमय->शतकौम्भमय
शातन->शतन
शतपादी->शतपदी
शतापदी->शतपदी
शतायुध->शतयुध
शतायुध->शतयूध
शत्रुतापन->शत्रुतपन
शत्रूषह्->शत्रुषह्
शत्रुसाह->शत्रुसह
शान->शन
शनैस्->शनैश्
शांतनूज->शंतनुज
शाब->शब
शाबरिका->शबरिका
शाबरि->शबरी
शब्दसाह->शब्दसह
शामा->शमा
शम्पाताल->शम्पातल
शम्भ->शंब
शाम्ब->शंब
शाम्बर->शंबर
शांभर->शंबर
शंभुवर्धन->शम्बुवर्धन
शंभु->शम्बू
शंभू->शम्बू
शाम्बु->शम्बू
शाम्बर->शंभर
शांभर->शंभर
शाम्बर->शम्भर
शांभर->शम्भर
शांभव->शम्भव
शंभू->शम्भु
शाम्बु->शम्भु
शंभूनाथ->शम्भुनाथ
शाम्बु->शम्भू
शयनैकादशी->शयनैकदशी
शायन->शयान
शायिन्->शयिन्
शराघात->शरघात
शारदातिलक->शरदातिलक
शरयू->शरयु
शारीरलक्षण->शरीरलक्षण
शार्क->शर्क
शार्ग->शर्घ
शर्ध->शर्द
शर्वाणी->शर्वणी
शर्वाणी->शर्वरी
शालन->शलङ
शालङ्क->शलङ्क
शालि->शली
शालु->शलु
शाल्मलि->शल्मली
शवर->शवण
शावर->शवण
शवाश->शवस
शशी->शशि
शस्तोक्थ->शस्तोक्त
शास्त्रकार->शस्त्रकार
शास्त्रवत्->शस्त्रवत्
शास्त्रिक->शस्त्रिक
शास्त्रित->शस्त्रित
शाकटायन->शाकटयन
शाकपूणि->शाकपुणि
शाकायन्य->शाकयन्य
शाङ्ख->शाङ्क
शाङ्खिक->शाङ्किक
शाठी->शाटी
शारि->शाणी
शाफाक्षि->शाफक्षि
शांभव->शाम्बव
शारदातिलक->शारदतिलक
शार्दूल->शार्दुल
शालास्तम्भ->शालस्तम्भ
शालीन->शालिन
शालीय->शालिय
शालीहोत्रमुनि->शालिहोत्रमुनि
शालूर->शालुर
शासक->शाशक
शीक्->शिक्
शिखरिन्->शिकरिन्
शीकरिन्->शिकरिन्
शीक्->शिख्
शिखिकण्ठ->शिखिकण्ट
शीघ्रबोध->शिघ्रबोध
शीघ्र्य->शिघ्र्य
शीत्->शित्
शिनीक->शिनिक
शिमीवन्त्->शिमिवन्त्
शिरस्->शिरश्
शिलींध्रक->शिलिंध्रक
शिल्पकार->शिल्पकर
शिवकारिणी->शिवकरिणि
शिवचतुर्दशी->शिवचतुर्दशि
शिवादेशक->शिवदेशक
शिवापर->शिवपर
शिवाप्रिया->शिवप्रिया
शिशूल->शिशुल
शिष्टाचार->शिष्टचार
शीतलाषष्ठी->शीतलषष्ठी
शुकफल->शुकपाल
शूकपिण्डि->शुकपिण्डी
शूकृत->शुकृत
शूर्->शुण्
शुर->शुण
शूर->शुण
शुण्ठि->शुण्टि
शुद्धायू->शुद्धायु
शूना->शुना
शुनासीर->शुनाशीर
शुभ्र->शुब्र
शूर्->शुर्
शूरपुत्रा->शुरपुत्रा
शूर्प->शुर्प
शूलपाल->शुलपाल
शूलापाल->शुलपाल
शुश्रूषक->शुश्रुषक
शूरी->शूरि
शूर्पखारी->शूर्पकारि
शूलकार->शूलकर
शृङ्घाणिका->शृङ्गारिका
शृङ्गीकनक->शृङ्गिकनक
शैख->शेक
शैखरिक->शेखरिक
शैबल->शेबल
शैल->शेल
शेषभूत->शेषभुत
शौचक->शोचक
शोणमणी->शोणमणि
शौण्डि->शोण्डी
शौधिका->शोधिका
शौन->शोन
शोली->शोलि
शौण्डीर->शौण्डिर
शौर्यौदार्यशृङ्गारमय->शौर्यौदर्यशृङ्गारमय
श्यावाश्व->श्यवाश्व
श्यामी->श्यामि
श्राण->श्रण
श्रद्धान->श्रद्दान
श्राद्ध->श्रद्ध
श्राद्धीय->श्रद्धीय
श्रावणविधि->श्रवणविधि
श्रावणिका->श्रवणिका
श्रीपति->श्रिपति
श्रीपर्णि->श्रिपर्णि
श्रीमल्लकर्णि->श्रिमल्लकर्णि
श्रीय->श्रिय
श्रीव्->श्रिव्
श्रीवृक्षक->श्रिवृक्षक
श्रीश->श्रिश
श्रीहर्ष->श्रिहर्ष
श्रीसुख->श्रीशुक
श्रुतश्रोणी->श्रुतश्रोणि
श्रूयमाणत्व->श्रुयमाणत्व
श्रेणीभूत->श्रेणिभूत
श्रेयांस->श्रेयांश
श्रेष्ठ->श्रेष्ट
श्रौषट्->श्रोषट्
श्रौष्टि->श्रोष्टि
श्लाख्->श्लक्
श्लाघ्->श्लग्
श्लिष्टाक्षेप->श्लिष्टक्षेप
श्वाशुरि->श्वशुरी
श्वास->श्वस
श्वाविध्->श्वाविद्
श्वेतरथ->श्वेतरत
श्वेतानूकाश->श्वेतानुकाश
श्वेताम्ली->श्वेताम्लि
श्वैति->श्वेती
श्वैत्रेय->श्वेत्रेय
षाट्->षट्
षाड्वर्गिक->षड्वर्गिक
षाड्वर्गिक->षड्वार्गिक
षष्ठिका->षष्टिका
षष्ठीप्रिय->षष्टीप्रिय
षाष्ठिक->षाष्टीक
षोढा->षोडा
ष्ठु->ष्टु
ष्ठीव->ष्ठिव
संयाति->संयति
संयाति->संयती
संयान->संयन
संयुयूषु->संयुयुषु
संवाच्->संवच्
संवाद्य->संवद्य
संवार्य->संवर्य
संवास->संवस
संविधा->संविदा
संविधान->संविदान
संसद्->संशद्
संसव->संशव
संहात्य->संहत्य
संहान->संहन
सकार->सकण
सकार->सकर
सकारविपुला->सकरविपुला
सघ->सग
संख्यामुष्ट्यधिकरणाक्षेप->संख्यामुष्ट्यधिकरणक्षेप
संघट->संगट
संघाट->संगट
संज्वारिन्->संज्वरिन्
सटाङ्क->सटङ्क
सतार->सतर
सतीय->सतिय
सत्पात्र->सत्पत्र
सत्यवाच्->सत्यवच्
सत्यावन्->सत्यवन्
सत्यावन्->सत्यवान्
सदीनम्->सदिनम्
सधिस्->सदिश्
सद्यस्->सद्यश्
सध्रि->सद्रि
सध्री->सद्रि
सधर्मचारिणी->सधर्मचारिणि
सनाथ->सनत
सनाथी->सनति
सनदीगिरिकानन->सनदीगिरिकनन
सनाजू->सनाजु
संतान->संतन
संधा->संदा
संधित->संदित
संधि->संदी
संद्राव->संद्रव
संधाय->संधय
संधिचौर->संधिचोर
संध्याभ्र->संध्यभ्र
संन्यासविधि->संन्यसविधि
सपत्नी->सपत्नि
सपात्र->सपत्र
सप्तहौत्र->सप्तहोत्र
सप्रतीवाप->सप्रतिवाप
समागति->समगति
समज्या->समज्ञा
समाज्ञा->समज्ञा
समथ->समत
समाति->समती
समातीत->समतीत
समाधि->समधी
समाधित->समधीत
समापन्न->समपान्न
समाम->समम
समायिन्->समयिन्
समाराण->समराण
समावन्त्->समवन्त्
समवसरण->समवशरण
समावाप्ति->समवाप्ति
समस्->समश्
समष्ठीला->समष्ठिला
समाचार->समाचर
समाधा->समादा
समानमान->समानमन
समाराण->समारण
समालम्भन->समालम्बन
समालम्भिन्->समालंबिन्
समावज्जामी->समावज्जामि
समाश्वास्य->समाश्वस्य
समित्समारोपणप्रातरौपासनप्रयोग->समित्समारोपणप्रातरौपसनप्रयोग
सामीची->समीची
समुदायिन्->समुदयिन्
समुद्घात->समुद्गत
सामुद्रि->समुद्रि
समुद्वाह->समुद्वह
समुपानयन->समुपनयन
सांघात->सम्गत
सांगम->सम्गम
संपाति->सम्पति
संपाद->सम्पद
सांपद->सम्पद
संपादिन्->सम्पदिन्
संपार->सम्पर
सांपराय->सम्पराय
सांपरायिक->सम्परायिक
संपावन->सम्पवन
संपाठ->सम्पाट
सांपद->सम्पाद
संप्रैष->सम्प्रेष
संफाल->सम्फल
संबाधन->संबधन
संभर->सम्बर
संभार->सम्बर
संभार्य->सम्बर्य
संभल->संबल
संभूत->सम्बूत
संभूति->सम्बूति
संभार->सम्भर
संभाव->सम्भव
संभावन->सम्भवन
संभाविन्->सम्भविन्
संभाव्य->सम्भव्य
संमाद->सम्मद
संमील्य->सम्मिल्य
सांयमनि->सम्यमनी
सांयाति->सम्याति
सांयुग->सम्युग
सांवत्सर->सम्वत्सर
सांवरण->सम्वरण
सांवर्त->सम्वर्त
सांवर्तक->सम्वर्तक
सांवृत्ति->सम्वृत्ति
सांहार->सम्हार
सरथ->सरत
सरसी->सरसि
सरस्वतीतीर्थ->सरस्वतितीर्थ
सर्पसत्त्र->सर्पशत्त्र
सर्वाकार->सर्वकर
सर्वतस्->सर्वतश्
सर्वाधार->सर्वधार
सर्वपाद->सर्वपद
सर्वमांसाद->सर्वमंसाद
सर्वाणी->सर्वरी
सर्वावन्त्->सर्ववन्त्
सर्वावास->सर्ववास
सवित्री->सवित्रि
ससित->सशित
ससीत->सशित
सस्यशूक->सस्यशुक
सहपांसुकिल->सहपांशुकिल
सहस्रसाव->सहस्रसव
सहस्रस्तरी->सहस्रस्तरि
सहस्रहर्याश्व->सहस्रहर्यश्व
सहैकस्थान->सहैकस्थन
सांस->सांश
सांसारिक->सांसरिक
सागरनेमी->सागरनेमि
सांक्रामिक->सांक्रमिक
सातीन->सातिन
सात्रासाह->सात्रासह
साधक->सादक
साधनी->सादनी
सानाथ्य->सानथ्य
सामात्य->सामत्य
सारक्षेत्रमाहात्म्य->सारक्षेत्रमाहत्म्य
सारप्रकाशिका->सारप्रकशिका
सारमेयादन->सारमेयदन
सारूप्य->सारुप्य
साहायक->साहयक
सिंहकेसर->सिंहकेशर
सीक्->सिक्
सिक्थक->सिक्तक
सीता->सिता
सितीवार->सितिवार
सिन्धुराव->सिन्धुरव
सीमिक->सिमीक
सीमीक->सिमीक
सीवक->सिवक
सीस->सिस
सीसक->सिसक
सीह->सिह
सीलन्ध->सीलन्द
सुकूर्कुर->सुकुर्कुर
सुखाकर->सुखकार
सुखालोक->सुखलोक
सुखावतीव्यूह->सुखवतीव्यूह
सुखावन्त्->सुखवन्त्
सुखार्थ->सुखार्त
सुखासन->सुखाशन
सुखी->सुखि
सुचीरा->सुचिरा
सूतक->सुतक
सूतता->सुतता
सूतपुत्र->सुतापुत्र
सुतीर्थ->सुतिर्थ
सूद->सुद
सुदंसस्->सुदंशस्
सुदाम->सुदम
सुदास्->सुदस्
सूद्य->सुद्य
सुधाय->सुधय
सूदकर्मन्->सुधाकर्मन्
सुधाधार->सुधाधर
सुधास्रवा->सुधाश्रवा
सून->सुन
सुनासीर->सुनाशीर
सुनीत->सुनित
सुनीथ->सुनित
सुनीहार->सुनिहार
सुपात्र->सुपत्र
सुप्तोत्थित->सुप्तोत्तिथ
सुप्रजास्त्व->सुप्रजस्त्व
सुप्रतीक->सुप्रतिक
सुप्रतिष्ठ->सुप्रतिष्ट
सुप्रतिष्ठित->सुप्रतिष्टित
सुप्रावी->सुप्रावि
सुभ्->सुब्
सुभाञ्जन->सुभञ्जन
सुभद्राविजय->सुभद्रविजय
सुभद्राहरण->सुभद्रहरण
सुभीत->सुभित
सुमज्जानि->सुमज्जनि
सुमनास्य->सुमनस्य
सुमनी->सुमनि
सुराति->सुरति
सुराधर->सुरदार
सुराधिप->सुरधिप
सूरसेन->सुरसेन
सूरि->सुरी
सूरी->सुरी
सूर्यवंश->सुर्यवंश
सूर्यवर->सुर्यवार
सूर्यवार->सुर्यवार
सुस्रोणि->सुश्रोणी
सूष्->सुष्
सुषीम->सुषिम
सुषूमा->सुषुमा
सुसंभ्रान्त->सुसंब्रान्त
सुहू->सुहु
सूखर->सूकार
सूचीखात->सूचिखात
सूचीपत्त्र->सूचिपत्त्र
सूचीमुख->सूचिमुख
सूरसूत->सूरसुत
सूर्याचन्द्रमसा->सूर्यचन्द्रमसा
सूर्यासूक्त->सूर्यसूक्त
सूलीक->सूलिक
सृगालजम्बू->सृगालजम्बु
सृणीका->सृणिका
सेनानी->सेनानि
सैरि->सेरि
सैस->सेश
सैनानीक->सैनानिक
सैन्धवायन->सैन्धवयान
सौक्ति->सोक्ति
सौडल->सोढल
सौभरि->सोभरी
सौभाञ्जन->सोभाञ्जन
सोमदैवत्य->सोमदेवत्य
सोमपात्र->सोमपत्र
सोमपीथ->सोमपिथ
सोमरात->सोमरथ
सोमारौद्र->सोमरौद्र
सौमारौद्र->सोमरौद्र
सोमाल->सोमल
सोमावती->सोमवती
सोमवल्लरी->सोमवल्लरि
सोमहूति->सोमहुति
सोमाहुति->सोमहुति
सौमाप->सोमाप
सौमायन->सोमायन
सौर->सोर
सौरण->सोरण
सौदामनी->सौदामनि
सौधाकर->सौधकार
सौभाग्य->सौभग्य
सौमी->सौमि
सौराष्ट्र->सौरष्ट्र
स्कन्ध्->स्कन्द्
स्कन्धफल->स्कन्दपाल
स्कन्धस्वाति->स्कन्दस्वाति
स्कन्धाक्ष->स्कन्दाक्ष
स्कन्दापस्मार->स्कन्दापस्मर
स्कन्धिक->स्कन्दिक
स्कन्धवाह->स्कन्धवह
स्थ->स्त
स्थानत्याग->स्तनत्याग
स्तब्धी->स्तब्धि
स्तम्भकर->स्तम्बकार
स्ताम्भिन्->स्तंभिन्
स्तरी->स्तरि
स्तर्तवै->स्तर्तवे
स्थावर->स्तवर
स्थवि->स्तवि
स्तीम->स्तिम
स्त्रीचौर->स्त्रीचोर
स्थागल->स्थगल
स्थान->स्थन
स्थलपद्मिनी->स्थलपद्मिनि
स्थाण्वाश्रममाहात्म्य->स्थाण्वाश्रममहात्म्य
स्थिरयौवन->स्थिरयोवन
स्थूणकर्ण->स्थुणाकर्ण
स्थूणाकर्ण->स्थुणाकर्ण
स्थूण->स्थुर
स्थूर->स्थुर
स्थूरि->स्थुरी
स्थूललक्ष->स्थुललक्ष
स्थूरिका->स्थूणिका
स्थूरि->स्थूणी
स्थूलाष्ठीव->स्थूलाष्टीव
स्थौलाष्ठीवि->स्थौलाष्टीवि
स्नाव->स्नव
स्नुह्->स्नुः
स्नुही->स्नुहि
स्पार्शन->स्पर्शान
स्फाटि->स्फटि
स्फाटि->स्फटी
स्फाल->स्फल
स्फीती->स्फीति
स्फूर्छ्->स्फुर्छ्
स्फूर्ज->स्फुर्ज
स्फूर्जक->स्फुर्जक
स्फूर्जथु->स्फुर्जथु
स्मरारि->स्मरणी
स्मार्य->स्मर्य
स्याल->स्यल
स्रंस्->स्रंश्
स्राक्->स्रक्
स्रुह्->स्रुः
स्रौतोवह->स्रोतोवह
स्वठ्->स्वट्
स्वाद->स्वद
स्वादर->स्वदार
स्वधावन्त्->स्वदावन्त्
स्वधित->स्वदित
स्वधीत->स्वदित
स्वादन->स्वधन
स्वादान->स्वधन
स्वधीति->स्वधिती
स्वानुरूप->स्वनुरूप
स्वब्राह्मण्या->स्वब्रह्मण्या
स्वयंभू->स्वयम्भु
स्वायंभुव->स्वयम्भुव
स्वारुह्->स्वरुः
स्वारुह्->स्वरुह्
स्वारूपा->स्वरूपा
स्वर्णपाठक->स्वर्णपाटक
स्वर्थ->स्वर्त
स्वार्थ->स्वर्त
स्वार्मौध्न->स्वर्मोध्न
स्वल्पकेसरिन्->स्वल्पकेशरिन्
स्वावेश->स्ववेश
स्वास्->स्वश्
स्वास्->स्वस्
स्वाशु->स्वसू
स्वस्वरूप->स्वस्वरुप
स्वाजीव->स्वाजिव
स्वादिष्ठ->स्वादिष्ट
स्वानुभाव->स्वानुभव
स्वीकार->स्वीकर
स्वूर्छ्->स्वुर्छ्
स्वैरता->स्वेरता
हंसतूल->हंसतुल
हंसावती->हंसवती
हठपर्णी->हटपर्णी
हर->हण
हनूमन्तेश्वर->हनुमन्तेश्वर
हनूष->हनुष
हम्भा->हंबा
हम्भा->हम्बा
हारिकण्ठ->हरिकण्ठ
हरिराय->हरिणाय
हरिदास->हरिदाश
हरिश्रावा->हरिश्रवा
हारि->हरी
हार्य->हर्य
हालक->हलक
हलाहल->हलहल
हालहल->हलहल
हालाहल->हलहल
हालिनी->हलिनी
हावनी->हवनी
हाविर्धानि->हविर्धानी
हवै->हवे
हस्तताल->हस्ततल
हस्तिकाश्यप->हस्तिकश्यप
हस्तीन->हस्तिन
हास्तिन->हस्तिन
हस्तिनापुर->हस्तिनपुर
हास्तिनपुर->हस्तिनपुर
हास्य->हस्य
हारीति->हारिती
हालाहल->हालहाल
हालिनी->हालिनि
हिल्->हिL
हीड->हिड
हिण्डी->हिण्डि
हिमावती->हिमवती
हीनकुष्ठ->हीनकुष्ट
हूण->हुण
हूण->हुर
हुरस्->हुरश्
हूर्छ्->हुर्छ्
हूष्कपुर->हुष्कपुर
हूहू->हूहु
हृदयाविध्->हृदयविध्
हेल्->हेL
हेलन->हेLअन
हेठ->हेट
हेतुरूपक->हेतुरुपक
हेमकारक->हेमकरक
हेमाभ->हेमभ
हैरम्ब->हेराम्ब
हेलञ्ची->हेलञ्चि
हैलिहिल->हेलिहिल
हेवाक->हेवक
हैहय->हेहय
हेहै->हेहे
होतुरन्तेवासिन्->होतुरन्तेवसिन्
ह्राद्->ह्रद्
ह्रास->ह्रस
ह्रिणीया->ह्रिणिया
ह्रूडु->ह्रुडू
ह्रूम्->ह्रुम्
ह्रौड्->ह्रोड्
