अपराःणक->अपराह्णक
असुक->असूक
आच्यदोह->आच्यादोह
आतीषदीय->आतीषादीय
आषाडी->आषाढी
इंकार->ईंकार
इन्दुकेशरिन्->इन्दुकेसरिन्
इलाय्->ईलय्
उत्पलवती->उत्पलावती
उपदेशसहस्री->उपदेशसाहस्री
उष्मपुर->ऊष्मपुर
एकव्यवहारिक->एकव्यावहारिक
एकशीति->एकाशीति
ऐन्द्रवरुण->ऐन्द्रावारुण
कन्यकुमारि->कन्यकुमारी
करालकेशर->करालकेसर
कुडुहुञ्ची->कुडूहुञ्ची
कृतकम->कृतकाम
क्रोलायन->क्रौलायन
गृहचार->गृहाचार
चतुःस्तन->चतुःस्थान
चतुरुषण->चतुरूषण
चिलिचिमि->चिलिचीमि
जम्बूनदमय->जाम्बुनदमय
ज्येष्ठसामिक->ज्यैष्ठसामिक
ज्वलारासभकामय->ज्वालारासभकामय
त्रैयरुण->त्रैयारुण
दर्शनवरणीय->दर्शनावरणीय
देवावस->देवावास
देवावस->दैववश
द्वदशमहावाक्य->द्वादशमहावाक्य
धूलिकदम्ब->धूलीकदम्ब
नेशिक->नैशिक
पत्त्रशिरा->पत्त्रसिरा
पराक्रमकेशरिन्->पराक्रमकेसरिन्
पुरुषकेशरिन्->पुरुषकेसरिन्
पुरुषघ्न->पूरुषघ्न
पूर्वभाद्रपदा->पूर्वाभाद्रपदा
बाध्योगायन->बाध्यौगायन
बावाशस्त्रिन्->बावाशास्त्रिन्
भ्रष्ट्रज->भ्राष्ट्रज
मसीधनी->मसीधानी
महारोद्र->महारौद्र
माधवश्रम->माधवाश्रम
रक्तकेशर->रक्तकेसर
लक्षणवादरहस्य->लक्षणावादरहस्य
लवणकर->लवणाकर
वनकण्डुल->वनकण्डूल
वारणकेशर->वारणकेसर
विक्रमकेशरिन्->विक्रमकेसरिन्
विचित्वरा->विचित्वारा
वीरकेशरिन्->वीरकेसरिन्
वैदेहिबन्धु->वैदेहीबन्धु
शंभर->शाम्भर
शाफक्षि->शाफाक्षि
शुद्धायु->शुद्धायू
श्लिष्टक्षेप->श्लिष्टाक्षेप
श्वेताम्लि->श्वेताम्ली
संवद्य->संवाद्य
सत्यवन्->सत्यवान्
सनाजु->सनाजू
समावज्जामि->समावज्जामी
सूलिक->सूलीक
स्वब्रह्मण्या->स्वब्राह्मण्या
अमृतमती->अमृतमति
अयाथतथ्य->अयथातथ्य
अराढ->अराड
अष्टापाद्->अष्टपद्
अष्टापाद्->अष्टापद्
आछ्->आच्
आज्ञाप्ति->आज्ञप्ति
उत्तरकामाख्यातन्त्र->उत्तरकामाख्यतन्त्र
उरसा->उरशा
ऊर्ध्वदंष्ट्राकेश->ऊर्ध्वदंष्ट्रकेश
ऐणीकीय->ऐणिकीय
काटुकि->कटुकी
कालाय->कालय
कुशाविन्दु->कुशविन्दु
केतसाप्->केतसप्
गर्धभि->गर्दभी
गिर्ववाह्->गिर्ववह्
गौष्ठी->गोष्ठी
चतुर्दशगुणानामन्->चतुर्दशगुणनामन्
जायन्ती->जयन्ती
दार्व्य->दर्व्य
दुःशाक->दुःशक
द्विचतुरस्रक->द्विचतुरश्रक
ध्वर->ध्वण
नवास्र->नवाश्र
नितान्तावृक्षीय->नितान्तवृक्षीय
पारढी->पारडी
पुरासाह्->पुरासह्
पूस->पुस
पूयवाह->पूयवह
प्रतिपत्नी->प्रतिपत्नि
भारवाह्->भारवह्
भिक्षुकीपारक->भिक्षुकीपराक
भूवाह्->भुवः
भूवाह्->भूवह्
महासफर->महाशफर
मांसेपाद्->मांसेपद्
मूखदूषण->मुखदूषण
रराठ्य->रराट्य
राजशूक->राजशुक
वाङ्घ्->वङ्घ्
वार्वरक->वर्वरक
शक्राग्नी->शक्राग्नि
शरिका->शणिका
शुनकचञ्चूका->शुनकचञ्चुका
षडस्र->षडश्र
संधनाजित्->संधनजित्
समुद्ररसन->समुद्ररशन
सांकुची->सांकुचि
सारमीति->सारमिति
सिद्धान्तलक्षणाक्रोड->सिद्धान्तलक्षणक्रोड
अजिनपत्री->अजीनपत्री
अधोगण्टा->अधोघण्ठा
अनड्वन्->अनड्वान्
अभिनिधनं->अभिनिधानं
अभिलष्य->अभिलाष्य
अमयाविन्->अमायाविन्
अहंप्रथमिका->अहंप्राथमिका
एकाकिकेशरिन्->एकाकिकेसरिन्
एतवाध्र्य->ऐतवाध्र्य
कशेरुमन्त्->कसेरुमन्त्
कशेरुमन्त्->कसेरूमन्त्
काङ्गुल->काङ्गूल
कुट्टपरान्त->कुट्टापरन्त
क्षीरय्->क्षीराय्
गुणनन्दी->गुणानन्दी
ज्ञौदनीय्->ज्ञौदानीय्
दक्षिणप्राञ्च्->दक्षिणाप्रञ्च्
दिनकेशर->दिनकेसर
नागाट्टयिक->नागाट्टायिक
निल->नीLअ
पञ्चपद्->पञ्चपाद्
पाङि->पानी
ब्रह्मपुष्पि->ब्राह्मपुष्पि
भगवद्भस्कर->भगवद्भास्कर
भदन्तगोषक->भदन्तघोषक
मधुकरि->मधुकरी
मधुकरि->मधुकारी
लच्छ्->लाच्छ्
वलिशि->वलिशी
विमलसरस्वति->विमलसरस्वती
वेटवन्त्->वेटावन्त्
व्यङ्गुलि->व्यङ्गुली
षरिज->षारिज
सौरथि->सौरथी
स्तम्बि->स्तम्भि
स्तम्बि->स्तम्भी
अमरूक->अमरुक
अराढ->अरड
अर्फ्->अर्प्
इम्मादिभारत्याचार्य->इम्मादिभारत्याचर्य
इल्लीस->इल्लिस
उच्चां->उच्चं
ऐरत->एणथ
ऐणीकीय->एणीकीय
काटर->कटर
काणेलीमातर्->काणेलिमातर्
कानूक->कानुक
कालास्य->कालस्य
कुराज->कुरज
कुराट->कुरठ
कौशलक->कोसलक
क्षेपाय्->क्षेपय्
गुणदीधितिटिप्पणी->गुणदिधितिटिप्पणी
चीरील्लि->चिरिल्ली
जायन्ती->जयन्ति
निःक्रामण->निःक्रमण
पारासु->परासू
पारास->पारश
फालिता->फलिता
मसीधनी->मसिधानी
मूर्खभूय->मूर्खभुय
रङ्गेष्ठालुक->रङ्गेष्टालुक
लाठ्य्->लाट्य्
वजहूण->वजहुण
वीढ->वीड
शंभर->शंबर
शरारीमुख->शरारिमुख
षडस्रि->षडश्रि
अंशुमन्त्->अंसुमन्त्
अग्निष्टोमहोत्र->अग्निष्टोमहौत्र
अदमुयञ्च्->अदमूयञ्च्
अन्दोलय्->अन्दोलाय्
अपचित्->अपाचित्
अपठ->अपाठ
अपति->अपाती
अपद->अपाद
अपदी->अपधी
अपधा->अपादा
अपधा->अपाधा
अपनुनुत्सु->अपानुनुत्सु
अपभ्रंश->अपभ्रंस
अपमित्य->अपामित्य
अपमृत्यु->अपामृत्यु
अपरपर->अपरापर
अपरपर->अपारपार
अपरभाव->अपराभव
अपरिजात->अपारिजात
अपरिवृत->अपरीवृत
अपल->अपाल
अपलित->अपालित
अपलित->अफलित
अपवरक->अपवारक
अपवर्तन->अपावर्तन
अपवारण->अपावरण
अपशु->अपसू
अपशु->अपासु
अपश्य->अपास्य
अपश्री->अपाश्रि
अपस्->अपास्
अपसरण->अपासरण
अपसारण->अपासरण
अपसी->अपासि
अपस्कर->अपस्कार
अपस्य->अपास्य
अपाटव->अपाठव
अपाला->अफला
अपोगण्ड->अपौगण्ड
अप्पदीक्षित->अप्पादीक्षित
अप्रकृत->अप्राकृत
अप्रज->अप्राझ
अप्रज्ञ->अप्राज्ञ
अप्रतिकर->अप्रतिकार
अप्रतिघ->अप्रतीघ
अप्रतिभा->अप्रतीभा
अप्रतीत->अप्रथित
अप्रभूति->अप्रभूती
अबधा->अबाधा
अबधिर->अबधीर
अबध्य->अबाध्य
अबल->अबाल
अबीज->अभिज
अबीज->अभिझ
अभिक्रम->अभिक्राम
अभिघात->अभीघात
अभिचर->अभीचार
अभिचार->अभीचार
अभिजात->अभिझात
अभिज्ञ->अभीज्य
अभिज्ञानशकुन्तल->अभिज्ञानशाकुन्तल
अभिनिष्टान->अभिनिष्ठान
अभिप्रेप्सु->अभिप्रेफ्सु
अभिभवन->अभिभावन
अभिमर्द->अभिमर्ध
अभिमर्दिन्->अभिमर्धिन्
अभियाति->अभियाती
अभिलाप->अभीलाप
अभिव्यक्ति->अभिव्यक्ती
अभिशङ्क्य->अभिसङ्ख्य
अभिशपन->अभिशापन
अभिशस्->अभिशास्
अभिषाह्->अभीषह्
अभिष्टि->अभीष्टि
अभिसर->अभीसार
अभिसरण->अभिसारण
अभिसार->अभीसार
अभिह्वर->अभिह्वार
अभीपद->अभीपाद
अभ्युच्छ्रय->अभ्युच्छ्राय
अभ्युपगम->अभ्युपागम
अमनि->अमनी
अमनुष्य->अमानुष्य
अमन्तु->अमन्थु
अमम->अमाम
अमम्रि->अमम्री
अमर->अमार
अमरक->अमारक
अमल->अमाल
अमस->अमास
अमामसी->अमामासी
अमावस्या->अमावास्या
अमित->अमीत
अमित्रिय->अमित्रीय
अमृतसू->अमृताशु
अम्ब्->अंभ्
अम्ब->अम्भ
अम्ब->अंभ
अम्बर->अम्भण
अम्बरिष->अंबरीष
अम्बि->अम्बी
अम्बुकण्टक->अम्बुकण्ठक
अम्बुकेशर->अम्बुकेसर
अम्बुधर->अम्बुधार
अम्लकेशर->अम्लकेसर
अयज्ञिय->अयज्ञीय
अयति->अयाति
अयथ->अयात
अयव->अयाव
अयवन्->अयावन्
अयवस्->अयावस्
अयवाह->अयावह
अरण->अराण
अरण्य->अरर्य
अरति->अरथि
अरम->अराम
अरर->अराण
अररक->अरराक
अरलुक->अरालुक
अरालि->अराली
अरिष्ट->अरिष्ठ
अरु->अरू
अरुणि->अरुणी
अरुन्धतीवट->अरुन्धतीवाट
अर्तन->अर्थन
अर्ति->अर्थि
अर्ति->अर्थी
अर्दनि->अर्धाङी
अर्धकील->अर्धखिल
अर्धखार->अर्धाकार
अर्धशन->अर्धाशन
अर्धहार->अर्धाहार
अर्धि->अर्धी
अर्शस->अर्सस
अर्हरिष्वणि->अर्हरिष्वाणि
अलक->अलाक
अलाबु->अलाबू
अलि->अली
अलिन->अलीन
अलिपक->अलीपक
अवंश->अवांश
अवकर->अवाकर
अवका->अवाका
अवखण्डन->अवखाण्डन
अवगुण->अवगुर
अवचनीय->अवाचनीय
अवचय->अवचाय
अवचर->अवचार
अवतरणिका->अवतारणिका
अवदानीय->अवधानीय
अवध->अवाद
अवधि->अवधी
अवधि->अवादी
अवनति->अवनती
अवनिप->अवनीप
अवनिरुह->अवनीरुह
अवन्तिपुर->अवन्तीपुर
अवन्तिब्रह्म->अवन्तीब्रह्म
अवन्तिसुन्दरी->अवन्तीसुन्दरी
अवन्तिसोम->अवन्तीसोम
अवबधा->अवबाधा
अवम->अवाम
अवमान->अवामन
अवलम्ब->अवालम्ब
अवस्->अवास्
अवसर->अवसार
अवस्कर->अवस्कार
अविक->अवीक
अविक्षित->अवीक्षित
अविदूर->अविधुर
अविद्य->अविध्य
अविपाल->अविफल
अविरत->अविरथ
अविस्तर->अविस्तार
अवीचि->अवीची
अवेद्य->अवेध्य
अवेद्य->अवैद्य
अव्यति->अव्यती
अशन्->अशान्
अशन->अशान
अशनि->अशनी
अशिक->अशिख
अशुन->अशून
अशेव->अशैव
अश्रद्ध->अश्राद्ध
अश्रिमन्त्->अश्रीमन्त्
अश्वमुख->अश्वामुख
अश्वयु->अश्वायु
अश्वशृगालिका->अश्वसृगालिका
अष्टनिधन->अष्टानिधन
अष्टपद->अष्टापाद
अष्टपदी->अष्टापदी
अष्टपाद्->अष्टापद्
अष्टपाद->अष्टापाद
अष्टमङ्गल->अष्टमाङ्गल
अष्टर्च->अष्टार्च
अष्टशत->अष्टाशत
अष्टषष्टि->अष्टाषष्टि
अष्टापद->अष्टापाद
असत्कर->असत्कार
असनि->असानि
असंदित->असंधित
असंभव्यम्->असंभाव्यम्
असहिष्णु->असाहिष्णु
असामन्य->असामान्य
असुख->असूक
असूसु->असूसू
अस्ताग->अस्थाघ
अस्ताघ->अस्थाघ
अस्ति->अस्ती
अस्ति->अस्थी
अस्त्रकण्टक->अस्त्रकण्ठक
अस्थाग->अस्थाघ
अस्थि->अस्थी
अस्रव->अस्राव
अस्ववेश->अस्वावेश
अह्->आः
अहत->अहात
अहहा->अहाहा
अहीरणि->अहीरणी
अह्निक->अह्नीक
आकरिन्->आकारिन्
आकुलि->आकुली
आके->आकै
आगत->आगथ
आगा->आघा
आगुर्->आगूर्
आगुरण->आगूरण
आग्निदत्तेय->आग्निदात्तेय
आग्निवेशि->आग्निवेशी
आघाटि->आघाटी
आङ्गि->आङ्गी
आच->आछ
आचरण->आचारण
आजगव->आजगाव
आजातशत्रव->आजातशात्रव
आजुर्->आजूर्
आज्यदोह->आज्यादोह
आडि->आडी
आणि->आरि
आतपन->आतापन
आतिश्वायन->आतिस्वायन
आत्त->आत्थ
आत्मगत->आत्मघात
आत्मगति->आत्मघाती
आत्मवध->आत्मवाद
आदन->आधन
आदातव्य->आधातव्य
आदान->आधन
आदाय->आधाय
आदारिन्->आधारिन्
आदि->आदी
आदिकर->आदिकार
आदित्यपत्र->आदित्यपात्र
आदित्व->आधित्व
आदित्सु->आधित्सु
आदिपुरुष->आदिपूरुष
आदृत->आधृत
आद्य->आध्य
आधुनिक->आधूनिक
आनकदुन्दुभि->आनकदुन्दुभी
आनन्दि->आनन्दी
आनर्द->आनर्ध
आनस->आनाश
आनिलि->आनिली
आनिलि->आनीली
आनुशूक->आनुसूक
आनुसुक->आनुसूक
आन्तरिक्ष->आन्तरीक्ष
आपतालिका->आपातालिका
आपतिक->आपातिक
आपदेव->आपादेव
आपस्तम्ब->आपस्तम्भ
आपातलिका->आपातालिका
आपीन->आफीन
आमल->आमाल
आमलक->आमालक
आयज्यु->आयाज्यु
आयत्ति->आयत्ती
आयमन->आयमान
आयोद->आयोध
आरट्ट->आरट्ठ
आरट्टज->आरठ्ठज
आरस->आरास
आरुह्->आरूः
आर्द->आर्ध
आर्षभि->आर्षभी
आलम्बिन्->आलंभिन्
आलि->आली
आलोकमथुरानाथी->आलोकमाथुरानाथी
आवत्->आवात्
आवलि->आवली
आवसति->आवसथी
आविद्->आविध्
आवुक->आवूक
आवेशिक->आवैशिक
आशय->आसय
आशस्->आशास्
आशसन->आशासन
आशाढ->आसड
आशास्य->आसस्य
आशि->आसि
आशिन->आशीन
आशिर्->आशीर्
आशिस्->आशीस्
आशिस्->आसीस्
आशी->आसि
आशीतिक->आसीतिक
आशु->आशू
आशु->आसु
आशु->आसू
आशुशुक्षणि->आशुशुक्षणी
आश्रि->आश्री
आश्व->आस्व
आषाढभव->आषाढाभव
आषाढि->आषाढी
आसदन->आसाधन
आसादन->आसाधन
आसुरि->आसुरी
आस्तिकार्थद->आस्तीकार्थद
आस्तिक्य->आस्तीक्य
आस्फोट->आस्फोठ
आहुत->आहूत
आहुति->आहुती
इख्->ईख्
इज्य->ईज्य
इञ्ज्->ईञ्ज्
इड->ईड
इड->ईढ
इडप्रजस्->इडाप्रजस्
इत्->ईत्
इत->ईत
इतस्->इथस्
इत्कट->इत्कठ
इन्->ईङ्
इन्दुमणि->इन्दुमणी
इन्द्रतुरीय->इन्द्रतूरीय
इन्द्रपर्वत->इन्द्रापर्वत
इन्द्रपाल->इन्द्रफल
इन्द्रवारुण->इन्द्रावरुण
इभकेशर->इभकेसर
इयक्ष्->ईयक्ष्
इयम्->ईयम्
इयम्->ईयाम्
इरा->ईरा
इराज->ईरज
इरिका->ईरिका
इल्->ईL
इल्->ईल्
इला->ईला
इलिनी->ईलिनी
इल्लिश->इल्लिस
इषुपथ->इषुपात
इष्टरश्मि->इष्टराश्मि
इहवन्त्->ईहावन्त्
उकनाह->उकानह
उक्थशस्->उक्थशास्
उक्षण->उक्षाण
उच्च->उच्छ
उच्चल->उच्छल
उच्चावच->उच्चावाच
उच्छ्वसित->उच्छ्वासित
उज्जिति->उज्झिति
उज्ज्वलन->उज्ज्वालन
उट->उठ
उड्र->उढ्र
उण्डुक->उण्डूक
उत्कलि->उत्खाली
उत्कुण->उत्कुर
उत्कूर्दन->उत्कूर्दान
उत्कोट->उत्कोठ
उत्क्रम->उत्क्राम
उत्खली->उत्खाली
उत्तपन->उत्तापन
उत्तभित->उत्थभित
उत्तमपुरुष->उत्तमपूरुष
उत्तरग्रन्थ->उत्तराग्रन्थ
उत्तरतन्त्र->उत्तरातन्त्र
उत्तरत्व->उत्तरात्व
उत्तरफल्गुनी->उत्तरफाल्गुनी
उत्तरवेदि->उत्तरवेदी
उत्तरोष्ठ->उत्तरौष्ठ
उत्पलशारिवा->उत्पलसारिवा
उत्पादशयन->उत्पादशयान
उत्पार->उत्फण
उत्पुत->उत्पूत
उत्सधि->उत्सादि
उत्सर->उत्सार
उत्सादन->उत्साधन
उद->उध
उदकधर->उदकाधार
उदकहार->उदकाहार
उदन्त->उदान्त
उदपू->उदापु
उदप्लुत->उदाप्लुत
उदयन->उदयान
उदयिन्->उदायिन्
उदराक्ष->उदाराक्ष
उदवाह->उदावह
उदसन->उदासन
उदहार->उदाहर
उदाप्यम्->उदाप्याम्
उदास->उधस
उदित->उदीत
उद्गल->उद्गाल
उद्गिरण->उद्गीरण
उद्दान->उद्धन
उद्धि->उद्धी
उद्भव->उद्भाव
उद्य->उध्य
उद्यति->उद्यती
उद्वपन->उद्वापन
उन्दन->उन्दान
उन्दुरु->उन्दूरु
उन्नति->उन्नती
उपक्वण->उपक्वाण
उपगत->उपागत
उपगम्य->उपागम्य
उपगा->उपागा
उपघात->उपागत
उपचय->उपचाय
उपचरण->उपाचरण
उपचिति->उपचिती
उपतपन्त्->उपतापन्त्
उपदश->उपदास
उपदा->उपादा
उपदा->उपाधा
उपदान->उपधन
उपदान->उपाधान
उपदानक->उपधानक
उपदानक->उपादानक
उपदिश्->उपादिश्
उपदी->उपधी
उपदीका->उपादिका
उपधा->उपादा
उपधा->उपाधा
उपधान->उपाधान
उपधि->उपधी
उपधेय->उपाधेय
उपध्मा->उपाध्मा
उपभृत्->उपाभृत्
उपयम->उपायम
उपयाम->उपायम
उपरोध->उपारोध
उपलक्ष्य->उपालक्ष्य
उपलब्धव्य->उपालब्धव्य
उपलिङ्ग->उपालिङ्ग
उपलिप्सु->उपालिप्सु
उपवह->उपवाह
उपविद्->उपविध्
उपवृत्ति->उपावृत्ति
उपशान्त्वन->उपसान्त्वन
उपशुनम्->उपसूनम्
उपशूनम्->उपसूनम्
उपश्री->उपाश्रि
उपसद्->उपसाध्
उपसद्->उपासद्
उपसद्य->उपसाद्य
उपसद्य->उपासाद्य
उपसर->उपाशार
उपस्तरण->उपास्तरण
उपस्ति->उपस्थि
उपस्था->उपास्था
उपस्थित->उपास्थित
उपहरण->उपाहरण
उपहार->उपाहार
उपादान->उपाधान
उपादेय->उपाधेय
उमाकट->उमाकठ
उर्->ऊर्
उर->ऊर
उररी->उरारि
उरुग्राह->ऊरुग्रह
उरूक->ऊरुक
उर्णा->ऊर्णा
उर्व्->ऊर्व्
उर्वङ्ग->ऊर्वङ्ग
उर्विया->उर्वीया
उल->ऊल
उलुप->उलूप
उलुपिन्->ऊलूपिन्
उलूपिन्->ऊलूपिन्
उलूपी->ऊलुपी
उशीर->उसीर
उषण->उषर
उष्णय्->उष्णाय्
उष्णि->उष्णी
उष्म->ऊष्म
उष्मस्वेद->ऊष्मस्वेद
उष्मायण->ऊष्मायण
उस्रिय->उस्रीय
उह्->ऊः
उहान->ऊहन
ऊर्णनाभि->ऊर्णनाभी
ऊर्णम्रदस्->ऊर्णाम्रदस्
ऊर्मि->ऊर्मी
ऊलुपिन्->ऊलूपिन्
ऋच्->ऋछ्
ऋजु->ऋजू
ऋतय्->ऋताय्
ऋतयु->ऋतायु
ऋताषह्->ऋताषाह्
ऋति->ऋती
ऋतीषह्->ऋतीषाह्
ऋतु->ऋथु
ऋश्यपद्->ऋश्यपाद्
ऋषिवत्->ऋषीवत्
एककर->एकाकर
एककर->एकाकार
एकपर->एकपाण
एकरात्रिक->ऐकरात्रिक
एकवर्णिक->ऐकवर्णिक
एकवीरकल्प->एकवीराकल्प
एकवेणि->एकवेणी
एकशाल->एकसाल
एकशितिपद्->एकशितिपाद्
एकशिला->एकशीला
एकैकश्य->ऐकैकश्य
एडुक->ऐडुक
एडूक->ऐडुक
एण->एर
एध->ऐध
एधा->ऐधा
एरण्ड->ऐरण्ड
एलक->ऐलक
एला->ऐला
एलाक->ऐलक
एलापत्र->ऐलपत्र
एषवीर->एषावीर
ऐन्द्रावरुण->ऐन्द्रावारुण
ऐन्द्रि->ऐन्द्री
ऐश्वरि->ऐश्वरी
ओक->ओख
ओकण->औकार
ओकार->औकार
ओणि->ओणी
ओल->औल
ओषधि->ओषधी
ओषधि->औषधी
ओष्ठ्य->औष्ठ्य
ओष्ण->औष्ण
औग्रसेनि->औग्रसेनी
औग्रसेन्य->औग्रसैन्य
औदास्य->औधस्य
औदुम्बरि->औदुम्बरी
औपगवि->औपगवी
औपग्रहिक->औपग्राहिक
औपनिषद->औपनिषध
औपवस्त->औपवस्थ
औरसि->औरसी
औशीनरि->औशीनरी
औशीनरि->औसीनरि
औषधि->औषधी
कंसवती->कंसावती
ककर->ककार
ककुद्मन्->ककुद्मान्
कक्षपुट->कक्षापुट
कङ्क->काङ्क
कङ्कटिक->कङ्कटीक
कङ्कत->काङ्कत
कङ्करोल->कङ्करौल
कङ्ख->काङ्क
कङ्गु->कङ्गू
कङ्गुल->काङ्गूल
कच्->काच्
कच्चर->कच्छार
कच्छप->काच्छप
कच्छर->कच्छार
कञ्चिका->काञ्चिका
कञ्चुकिन्->काञ्चुकिन्
कञ्चुकीय->काञ्चुकीय
कञ्चुलिका->कञ्चुलीका
कञ्जिका->काञ्जिका
कटक->कठक
कटम्बरा->कटंभरा
कटम्बरा->कटम्भरा
कटाक्ष->काटाक्ष
कटि->कठि
कटि->कठी
कटिल्लक->कठिल्लक
कटिसूत्र->कटीसूत्र
कटी->कठि
कटी->कठी
कटुकरोहिणी->कटुकारोहिणी
कणिक->करिक
कणिक->काणिक
कणीक->करिक
कणीक->काणिक
कणेर->करेर
कणेरु->करेणू
कण्टक->काण्टक
कण्टकाल->कण्ठकाल
कण्टकिल->कण्टाकिल
कण्ठक->काण्टक
कण्ठगत->कण्ठागत
कण्ठरव->कण्ठारव
कण्डरीक->काण्डरिक
कण्डुक->कण्डूक
कण्डुर->कण्डूर
कण्व->काण्Vअ
कत->कथ
कति->कथी
कतिथ->कथित
कत्थक->कात्थक
कद->कध
कदम्बयुद्ध->कादम्बयुद्ध
कदर->कदार
कदल->कादल
कद्रु->कद्रू
कद्रुक->कद्रूक
कद्रुण->कद्रूण
कधप्रिय->कधाप्रिय
कनकपल->कनकफल
कनी->कानी
कनेरिन्->कानेरिन्
कन्थरी->कान्तारी
कन्था->कान्ता
कन्थारी->कान्तारी
कन्द->कन्ध
कन्दर->कन्धर
कन्दी->कन्धि
कपालि->कपाली
कपालि->कापाली
कपालिका->कापालिका
कपालिन->कपालीन
कपि->कफी
कपिकच्छु->कपिकच्छू
कपिकच्छु->कपीकच्छू
कपिकच्छुफलोपमा->कपिकच्छूफलोपमा
कपिकच्छुरा->कपिकच्छूरा
कपिञ्जलाद->कापिञ्जलाद
कपिल->कफिल
कपिलधारा->कपिलाधारा
कपिष्ठल->कपिष्ठाल
कपीकच्छु->कपीकच्छू
कपोतरेतस->कापोतरेतस
कपोल->कापोल
कबन्ध->काबन्ध
कबर->काबर
कमन्तक->कामान्तक
कमलवती->कमलावती
कमा->कामा
कम्पिल->कम्पील
कम्बु->कंबू
कम्बु->कंभु
कम्बु->कम्भू
कम्बुक->काम्बुक
कम्बू->कंभु
कम्बू->कम्भू
कम्बूक->काम्बुक
कम्भु->कम्भू
कयस्था->कायस्था
कय्य->काय्य
करकण्टक->करकण्ठक
करग्रह->करग्राह
करटक->कारटक
करणि->करणी
करणिन्->कारणिन्
करमर्द->करामर्ध
करवी->कारावी
करशीकर->करसीकर
करापात->कारपथ
करामर्द->करामर्ध
करारिन्->कारणिन्
करि->करी
करि->काणि
करि->कारी
करीषगन्धि->कारीषगन्धि
करुणमल्ली->करुणामल्ली
करूकर->कारुकर
करेणु->करेणू
करोटक->कारोटक
करोटि->करोटी
कर्कटक->कार्कटक
कर्कटि->कर्कटी
कर्कन्धु->कर्कन्धू
कर्कर->कर्कार
कर्करि->कर्करी
कर्कि->कार्कि
कर्की->कार्कि
कर्णकवन्त्->कर्णकावन्त्
कर्णन्दु->कर्णान्दू
कर्णप्रतिनाह->कर्णप्रतीनाह
कर्णश्रव->कर्णस्राव
कर्णाकर्णि->कर्णाकर्णी
कर्णाटक->कार्णाटक
कर्णान्दु->कर्णान्दू
कर्णिक->कार्णिक
कर्तरिका->कर्तरीका
कर्पूर->कार्पूर
कर्बु->कर्बू
कर्मक्षम->कर्माक्षम
कर्मण्यभुज्->कर्मण्याभुज्
कर्मरङ्ग->कार्मरङ्ग
कर्मान्तिक->कार्मान्तिक
कर्मारक->कार्मणक
कर्व->काण्Vअ
कलम->कलाम
कलश->कलास
कलशि->कलशी
कलशि->कलसि
कलशि->कलसी
कलशीसुत->कलसीसुत
कलशोदर->कलसोदर
कलस->कलास
कलि->कली
कलिद्रुम->कलिद्रूम
कल्कि->कल्की
कल्लट->कल्लाट
कवटी->कवाटी
कवलग्रह->कवलग्राह
कवारि->कवारी
कवि->कवी
कशेरु->कशेरू
कशेरुक->कसेरुक
कस्तुरिका->कस्तूरिका
कांशि->कांसी
काकजम्बु->काकजम्बू
काकण->काकर
काकणि->काकणी
काकन्दि->काकन्दी
काकन्दि->काकान्दी
काकि->काकी
काकु->काकू
काकोष्ठक->काकौष्ठक
काङ्गा->काङ्घा
काणभुज->काणभूज
काण्ठेविद्धि->काण्ठेविद्धी
कान्तलोह->कान्तलौह
कान्तिक->कान्तीक
कापालि->कापाली
कापोति->कापोती
कामचर->कामाचार
कामचार->कामाचार
कामन्दकि->कामन्दकी
कामलि->कामली
कामशर->कामसार
कामाशन->कामासन
कामि->कामी
काम्बोजि->काम्बोजी
कारकर->काराकार
कारवी->कारावी
कारि->कारी
कारिकेयि->कारिकेयी
कार्षि->कार्षी
कार्ष्णि->कार्ष्णी
कालकञ्ज्य->कालकाञ्ज्य
कालनेमि->कालनेमी
कालरात्रि->कालरात्री
कालायनि->कालायनी
काशक->कासक
काशय->काशाय
काशि->कासी
काशिपति->काशीपति
काशिपति->कासीपति
काशिराम->काशीराम
काशी->कासी
काशेरुयज्ञिक->कासेरुयज्ञिक
काश्यप->कास्यप
काश्यपि->काश्यपी
काष्ठलोहिन्->काष्ठलौहिन्
काष्ठशारिवा->काष्ठसारिवा
काहलि->काहली
कि->की
किंवदन्ति->किम्वदन्ती
किंवदन्ती->किम्वदन्ति
किंशारु->किंसारु
किकि->किकी
किक्किश->किक्किस
किङ्कणी->किङ्करी
किङ्किणी->किङ्किरी
किटि->कीटी
किणि->किणी
किंपुरुष->किंपूरुष
किंपुरुष->किम्पूरुष
किराति->किराती
किरिटि->किरिटी
किरिटि->किरीटी
किर्मी->कीर्मी
कीटमणि->कीटमारी
कुंश्->कुंस्
कुंश->कुंस
कुकूल->कूकुल
कुक्कुटि->कुक्कुटी
कुचिका->कूचीका
कुज्जिश->कुज्झिश
कुज्झटि->कुज्झटी
कुञ्चि->कुञ्ची
कुञ्जराशन->कुञ्जरासन
कुट्->कुठ्
कुटि->कूटि
कुटि->कूटी
कुटी->कूटि
कुटी->कूटी
कुट्टल->कुट्टाल
कुठि->कूटि
कुठि->कूटी
कुण->कुर
कुण->कूण
कुणक->कुरक
कुणावी->कुरवी
कुण्डलिका->कुण्डलीका
कुण्डिक->कुण्डीक
कुदार->कुधर
कुनदीक->कुनादिक
कुन्ति->कुन्ती
कुन्तिभोज->कुन्तीभोज
कुपय->कूपाय
कुपिनी->कूपिनी
कुब्र->कुभ्र
कुम्भिका->कुम्भीका
कुम्भीनसि->कुम्भीनसी
कुयव->कूयव
कुरङ्गनाभि->कुरङ्गनाभी
कुरट->कुरठ
कुरर->कुरार
कुरीरिन्->कुरीरीन्
कुरुण्ट->कुरुण्ठ
कुर्पास->कूर्पस
कुलजात->कूलजात
कुलपालि->कुलपाली
कुलाल->कूलाल
कुलिक->कुलीक
कुलीका->कूलिका
कुलेचर->कूलेचर
कुल्या->कूल्या
कुल्व->कूल्व
कुवीणा->कुवीरा
कुश->कुस
कुशर->कुसर
कुशल->कुशाल
कुशाल्मलि->कुशाल्मली
कुशिक->कुसिक
कुशिम्बि->कुशिम्बी
कुशीति->कुशीती
कुशुम्भ->कुसुम्ब
कुशोदका->कुसोदका
कुसुमशर->कुसुमसर
कुह्->कूः
कुहलि->कुहली
कुहूरव->कुहूराव
कूचिका->कूचीका
कूटशाल्मलि->कूटशाल्मली
कूपद->कूपाद
कूर्चल->कूर्चाल
कूर्मपुराण->कूर्मपूराण
कूर्मि->कूर्मी
कूश्माण्ड->कूस्माण्ड
कृकदाशु->कृकदाशू
कृत्->कॄत्
कृत->कॄत
कृतदार->कृतधार
कृतदार->कृतादर
कृतरथ->कृतरात
कृतश्रम->कृतश्राम
कृतसापत्निका->कृतसापत्नीका
कृताञ्जलि->कृताञ्जली
कृति->कृती
कृथ->कॄत
कृपाणि->कृपाणी
कृमि->कृमी
कृवि->कृवी
कृषर->कृषाण
कृषि->कृषी
कृष्णगङ्गा->कृष्णागङ्गा
कृष्णिय->कृष्णीय
केकय->केकाय
केकेयी->कैकेयी
केलि->केली
केलिकिल->कैलिकिल
केश->केस
केशवादित्य->केशावादित्य
केशारि->केसरी
केशारुका->केसारुका
केशि->केशी
केसरि->केसरी
कोकिलहोत्र->कोकिलहौत्र
कोङ्कण->कोङ्कार
कोङ्काण->कोङ्कार
कोटक->कोठक
कोटि->कोटी
कोटि->कोठी
कोटिकर्ण->कोटीकर्ण
कोणाकोणि->कोणाकोणी
कोण्डभट्ट->कौण्डभट्ट
कोन्तल->कौन्तल
कोर->कौर
कोलि->कोली
कोलि->कौली
कोलि->खोली
कोश->कोस
कोशिका->कौशिका
कोहलीय->कौहलीय
कौज->खोज
कौट->खोट
कौण्य->कौर्य
कौमुदिक->कौमुदीक
कौरुकत्य->कौरुकात्य
कौरुजङ्गल->कौरुजाङ्गल
कौरुपञ्चाल->कौरुपाञ्चाल
कौलि->कौली
कौलि->खोली
कौशलि->कौशली
कौशलि->कौसली
कौशाम्बि->कौशाम्बी
कौशाम्बि->कौशांबी
कौशिक->कौशीक
कौषीतकि->कौषीतकी
कौहलिय->कौहलीय
क्रमिक->क्रामिक
क्रय->क्राय
क्रयि->क्रयी
क्रयिक->क्रायिक
क्रेणि->क्रेणी
क्रोञ्चदारण->क्रौञ्चदारण
क्रोञ्चपदी->क्रौञ्चपादी
क्रौञ्चपदी->क्रौञ्चपादी
क्रौञ्चादन->क्रौञ्चादान
क्लीबय्->क्लीबाय्
क्वयि->क्वयी
क्षणदाचर->क्षणदाचार
क्षणित->क्षरित
क्षणित->क्षारित
क्षत्रिय->क्षात्रिय
क्षत्रियाणी->क्षत्रियारि
क्षमता->क्षामता
क्षमत्व->क्षामत्व
क्षमावती->क्षामवती
क्षस्->क्षास्
क्षान्ति->क्षान्ती
क्षामि->क्षामी
क्षिपणि->क्षिपणी
क्षीरषष्टिक->क्षीरषाष्टिक
क्षुण->क्षूण
क्षुद->क्षुध
क्षुद्रवर्वणा->क्षुद्रवर्वरा
क्षुर->क्षूण
क्षेत्रिय->क्षेत्रीय
क्षेपणि->क्षेपणी
क्षोण->क्षोर
क्षोणी->क्षौणि
क्षोणी->क्षौरी
क्षौणी->क्षौरी
क्ष्णु->क्ष्णू
क्ष्वेलि->क्ष्वेली
खङ्कर->खङ्खण
खङ्ख->खाङ्क
खटिक->खटीक
खटी->खाटी
खट्टाश->खट्टास
खडिक->खाडिक
खड्गधर->खड्गाधार
खड्गपत्र->खड्गपात्र
खड्गिक->खाड्गिक
खड्गिन्->खाड्गिन्
खड्गीक->खाड्गिक
खण्डक->खाण्डक
खण्डसर->खण्डसार
खण्डिक->खण्डीक
खनि->खनी
खनि->खानी
खनिनेत्र->खनीनेत्र
खमूलि->खमूली
खरिका->खरीका
खरीजङ्घ->खारीजङ्घ
खरु->खाणु
खरोष्टी->खरोष्ठी
खर्जुरकर्ण->खर्जूरकर्ण
खर्जुरकर्ण->खार्जूरकर्ण
खर्परिका->खर्परीका
खर्वुरा->खर्वूरा
खलि->खली
खशीर->खाशीर
खसाक->खासक
खसीक->खाशिक
खस्फटिक->खस्फाटिक
खाटि->खाटी
खानि->खानी
खार्जुरकर्ण->खार्जूरकर्ण
खोलि->खोली
खोल्मुक->खोल्मुख
ख्याति->ख्याती
गङ्गदत्त->गङ्गादत्त
गङ्गाटेय->गाङ्गटेय
गङ्गाधर->गङ्गाधार
गज->गाज
गजवीथि->गजवीथी
गजानन->गजानान
गडिक->गाडिक
गड्डुक->गड्डूक
गणि->गरि
गणि->गरी
गणिका->गरिका
गण्डिका->गण्डीका
गण्डु->गण्डू
गण्डुल->गण्डूल
गदाभृत्->गधाभृत्
गदि->गदी
गन्दिका->गन्धिका
गन्धमादन->गन्धमाधन
गन्धारि->गन्धारी
गन्धोतु->गन्धौतु
गभस्ति->गभस्ती
गमिन्->गमीन्
गमिष्ठ->गमीष्ठ
गम्भीरशील->गम्भीरसील
गर्ग->गर्घ
गर्दभि->गर्दभी
गर्भधि->गर्भादि
गर्भावतरण->गर्भावतारण
गवाशन->गवासन
गविनी->गवीनी
गविष्टि->गविष्ठि
गवीनि->गवीनी
गाञ्जिकाय->गाञ्जीकाय
गाढमुष्टि->गाढमुष्ठि
गाथानी->घातनी
गाथिका->घातिका
गान्दी->गान्धी
गान्धारि->गान्धारी
गायत्रि->गायत्री
गार->घण
गार->घर
गार्गर्य->घर्घर्य
गार्ग्यायणि->गार्ग्यायणी
गार्तक->घार्तक
गार्भ->घर्ब
गालि->गाली
गाह्->घः
गिर्->गीर्
गिर्->घिण्
गिर->घिण
गिरि->गिरी
गिरि->घिणि
गिरियक->गिरियाक
गिल्->घिल्
गीत->गीथ
गुङ्गु->गुङ्गू
गुटिका->घुटिका
गुड->घुड
गुडक->गूढक
गुडाशय->गूढाशय
गुण->गुर
गुण->गूर
गुण->घुर
गुण->घूर
गुणक->घुणक
गुणिका->घुरिका
गुणी->गुरी
गुणी->गूरी
गुणी->घुरी
गुणी->घूरी
गुण्थ->गूर्त
गुद->गुध
गुप्ति->गुप्ती
गुरु->गुरू
गुर्द्->गूर्ध्
गुलुगुधा->गुलूगुधा
गुह्->गूः
गुह्->घुः
गुह->गूह
गुहा->गूहा
गूढ->घुड
गूर्द्->गूर्ध्
गूह्->घुः
गृण्डिव->गृण्डीव
गृध्रजम्बूक->गृध्रजम्भूक
गृभय्->गृभाय्
गृहचुल्ली->गृहचूल्ली
गृहदीप्ति->गृहादीप्ति
गृहभर्तर्->गृहभार्तर्
गृहशुक->गृहाशुक
गृहि->गृही
गृहु->गृहू
गो->गौ
गोकण्टक->गोकण्ठक
गोड->घोड
गोण->घोण
गोणि->गौणी
गोणि->गौरी
गोणि->घोणी
गोणि->घोरी
गोणी->गौणी
गोणी->गौरी
गोणी->घोणी
गोणी->घोरी
गोण्डकिरी->गौण्डकिरी
गोतमपृच्छा->गौतमपृच्छा
गोतमान्वय->गौतमान्वय
गोतमीपुत्र->गौतमीपुत्र
गोद->गौद
गोदाय->गोधाय
गोध->गौद
गोधर->गोधार
गोप->गौप
गोपालि->गोपाली
गोपालि->गौपालि
गोपिल->गोफिल
गोपिल->गौफिल
गोभिल->गौभिल
गोमति->गोमती
गोमति->गौमती
गोयूति->गोयूथी
गोरण->घोरण
गोरथ->गौरथ
गोराटिका->गौराटिका
गोरिका->गौरिका
गोरिका->घोरिका
गोलाङ्गुल->गोलाङ्गूल
गोलिका->घोलिका
गोवर्धनीय->गौवर्धनीय
गोशे->गोसे
गोषा->घोषा
गोषादी->घोषादि
गोषादी->घोषादी
गोष्ट्->गोष्ठ्
गोष्ठ->गौष्ठ
गोष्ठि->गोष्ठी
गोष्ठिक->गौष्ठिक
गोष्ठीक->गौष्ठिक
गोह्य->गौह्य
गौकक्ष्यायणि->गौकक्ष्यायणी
गौड->घोड
गौण->घोण
गौणत्व->गौरत्व
गौणत्व->घोरत्व
गौतमि->गौतमी
गौपिलेय->गौफिलेय
गौर->घोण
गौरखर->घोराकार
गौरि->गौरी
गौरि->घोणी
गौरि->घोरी
गौरिवीति->गौरीविति
गौला->घोला
ग्रन्थविस्तर->ग्रन्थविस्तार
ग्रन्थि->ग्रन्थी
ग्रस्->घ्रस्
ग्रहण->ग्राहण
ग्रहि->ग्राही
ग्रहिका->ग्राहिका
ग्रामटिका->ग्रामाटिका
ग्राहि->ग्राही
घटक->घाटक
घटाल->घाटल
घटि->घाटि
घटिघट->घटीघट
घटी->घाटि
घटीका->घाटिका
घण्टक->घाण्टक
घण्टाक->घाण्टक
घण्टापाटलि->घण्टापाटली
घण्टारव->घण्टाराव
घर्घुर्घा->घर्घूर्घा
घर्माम्बु->घार्माम्बु
घुण->घुर
घुण->घूर
घुणि->घुरी
घुणि->घूरी
घुर्घुरक->घुर्घूरक
घोणा->घोरा
घोलि->घोली
चक्रधर->चक्रधार
चक्रनेमि->चक्रनेमी
चक्रि->चक्री
चक्षु->चक्षू
चटिका->चठिका
चटुल्लोल->चटूल्लोल
चण्डि->चण्डी
चतु->चतू
चतुःसन->चतुह्सन
चतुरध्यायिका->चतुराध्यायिका
चतुरश्रि->चतुरश्री
चतुस्तन->चतुस्थान
चत्वर्->चत्वार्
चन्दन->चन्धन
चन्दनशारिवा->चन्दनसारिवा
चन्द्रगिरि->चन्द्रगिरी
चन्द्रभास->चन्द्राभास
चन्द्रलोहक->चन्द्रलौहक
चन्द्रवसा->चन्द्रवासा
चन्द्राकर->चन्द्राकार
चन्द्रि->चन्द्री
चन्द्रिका->चन्द्रीका
चमत्करण->चमत्कारण
चमसि->चमसी
चरणि->चारणी
चरथ->चराथ
चरि->चरी
चरि->चारी
चरित->चारित
चर्पटि->चर्पटी
चर्व्->चार्व्
चर्षणि->चर्षणी
चल्->छल्
चलता->छलता
चलातङ्क->चलातङ्ख
चलि->चाली
चलि->छाली
चली->चाली
चली->छाली
चवि->चवी
चवि->छावी
चशाल->चसाल
चह्->छः
चह्->छाः
चाङ्ग->छङ्ग
चाट->छाट
चाणक->छरक
चाणक->छाणक
चातुर्विद्य->चातुर्वीद्य
चातुर्विध्य->चातुर्वीद्य
चात्र->छत्र
चात्र->छात्र
चान्द्रभागा->छन्द्रभागा
चान्द्रभागि->चान्द्रभागी
चाप->छप
चायु->छयु
चारक->छरक
चारक->छाणक
चारुकेशरा->चारुकेसरा
चारुमति->चारुमती
चाष->छष
चिक->चीक
चिकरिषु->चिकारिषु
चिकित्वन्->चिकित्वान्
चिक्कण->छिक्कण
चिचीकुची->चीचीकुची
चिच्चिटिङ्ग->चिच्छिटिङ्ग
चित्->चीत्
चित्->छित्
चिति->चिती
चित्कारवन्त्->चीत्कारवन्त्
चित्ति->चित्ती
चित्रवहा->चित्रवाहा
चित्रशाकपूपभक्ष्यविकारक्रिया->चित्रशाकापूपभक्ष्यविकारक्रिया
चित्रसङ्ग->चित्रासङ्ग
चित्रिय->चित्रीय
चिरण्टी->चिरण्ठी
चिरम्भण->चीराम्बर
चिरिण्टी->चिरिण्ठी
चिलिचिम->चिलिचीम
चिलिचिम->चिलीचिम
चिल्लक->चील्लक
चिल्लि->चिल्ली
चिविल्लिका->चीविल्लिका
चीनपिष्ट->चीनपिष्ठ
चुचु->चूचु
चुचुक->चूचूक
चुचू->चूचु
चुचूक->चूचूक
चुच्चू->छुच्छु
चुञ्चुलि->चुञ्चुली
चुट्ट्->छुट्ट्
चुड्->चुढ्
चुर->चूण
चुर->चूर
चुर->छुर
चुरी->चूरी
चूचुक->चूचूक
चूड->छुड
चूरि->चूरी
चूर्णि->चूर्णी
चेतकी->चैतकि
चेतय->चेताय
चेद्->छेद्
चेदि->चेदी
चेदि->छेदी
चेदिक->छेदिक
चेलक->छेलक
चेलिका->छेलिका
चैत्ररथि->चैत्ररथी
चैत्रि->चैत्री
चैदिक->छेदिक
चैलक->छेलक
चोटी->छोटि
चोटी->छोटी
चोरक->चौरक
चौण्ट्य->चौण्ठ्य
चौहाण->चौहार
छन्दु->छन्दू
छन्दोग->छन्दोघ
छन्दोमञ्जरि->छन्दोमञ्जरी
छर्दापनिका->छर्दापनीका
छवि->छावी
छायाग्रह->छायाग्राह
छुच्छुन्दर->छुच्छून्दर
छेदि->छेदी
छो->छौ
जगर->जगार
जघन->जघान
जघन->जाघन
जङ्गल->जङ्घल
जङ्गाल->जङ्घल
जङ्गिड->जङ्गीड
जज्ज->जज्झ
जज्ज->जझ्झ
जटामांसी->जाटामांसी
जटालिका->जाटलिका
जटोच्च->जटोच्छ
जतु->जतू
जतूकर्ण->जातुकर्ण
जनकरी->जनकारी
जनत्->जानत्
जनन->जानन
जनन->जानान
जननि->जननी
जनपद->जानपाद
जनरव->जनारव
जनु->जनू
जन्मभूमि->जन्मभूमी
जमदग्नि->जामदग्नि
जम्बु->जम्बू
जम्बुप्रस्थ->जम्बूप्रस्थ
जम्बुवनज->जम्बूवनज
जम्बूनदप्रभ->जाम्बूनदप्रभ
जम्बूनदी->जाम्बूनदी
जम्बूलमालिका->जाम्बूलमालिका
जय->जाय
जयवन्त्->जायावन्त्
जयादित्य->जयाधित्य
जयितर्->जायितर्
जरण->जरर
जरणा->जारणा
जरद्गववीथि->जारद्गवावीथि
जरमाण->जारमाण
जरस->जरास
जरित->जारित
जरिन्->जारिन्
जर्च्->जर्छ्
जलधि->जलधी
जलधि->जालधि
जलपाद->जालपद
जलब्रह्मी->जलब्राह्मी
जलभूषण->जालभूषण
जलमार्ग->जालमार्ग
जलमोद->जलामोद
जलवास->जलावास
जलशायिन्->जलाशायिन्
जलशूकर->जलसूकर
जलालुक->जलालूक
जलाषह्->जलाषाह्
जलिका->जालिका
जव->जाव
जवनिका->जावनिका
जविन->जवीन
जहल्लक्षणा->जहाल्लक्षणा
जहिस्तम्ब->जहिस्तम्भ
जह्नावी->जाह्नवि
जह्नावी->जाह्नवी
जाङ्गलि->जाङ्गली
जाङ्गलिक->जाङ्गलीक
जाङ्गुलि->जाङ्गुली
जाजलि->जाझालि
जातकर्मन्->जातकार्मन्
जातवेदस्->जातावेदस्
जातिकोश->जातीकोश
जातिपत्त्री->जातीपत्त्री
जातिफल->जातीफल
जानकि->जानकी
जानपद->जानपाद
जामि->जामी
जिङ्गी->जिङ्घि
जितकाशि->जितकाशी
जितकाशिन्->जितकासिन्
जिवाजिव->जिवाजीव
जिहिति->जिहीति
जिह्वल->जिह्वाल
जीमूतकुट->जीमूतकूट
जीवग्रह->जीवग्राह
जीवनि->जीवनी
जीवन्ति->जीवन्ती
जीवादान->जीवाधान
जु->झु
जुष->झूष
जू->झु
जूष->झूष
जेह्->झेः
जोटिङ्ग->जोटीङ्ग
ज्ञता->ज्ञाता
ज्ञानकाण्ड->ज्ञानखण्ड
ज्ञानोत्तम->ज्ञानौत्तम
ज्ञुबाध्->ज्ञुभाध्
ज्योति->ज्योती
ज्योतिषिक->ज्योतिषीक
ज्योत्स्नी->ज्यौत्स्नी
ज्रि->ज्री
ज्वलन->ज्वालन
ज्वलमुखी->ज्वालामुखी
झंकार->झांकार
झंकारित->झांकारित
झंकारिन्->झांकारिन्
झटा->झाटा
झटि->झाटि
झण्टि->झण्टी
झर्च्->झर्छ्
झर्झरीक->झार्झरिक
झलरी->झालरी
झल्लिका->झल्लीका
झाटल->झाटाल
झाटिका->झाटीका
झावु->झावू
झिरिका->झिरीका
झिल्लिका->झिल्लीका
झिल्लीक->झील्लिक
टक्क->ठक्क
टक्कदेशीय->टक्कादेशीय
टङ्क्->टाङ्क्
टङ्कण->टङ्कार
टङ्कण->टाङ्कर
टङ्कण->टाङ्कार
टाक->ठक
टिट्टिभ->टीट्टिभ
टिण्टिणि->टिण्ठिणि
टिण्टिणिका->टिण्टिणीका
टुण्टुक->टुण्ठुक
ट्वल->ट्वाल
डकर->डकार
डकर->ढकार
डम्ब्->डंभ्
डहु->डहू
डाहल->डाहाल
डाहुक->डाहूक
डिल्ली->ढिल्ली
डोर->ढौर
ढण्टी->ढण्ठी
तङ्क्->ताङ्क्
तड्->ताड्
तडाक->ताडक
तडि->ताडी
तण्ड्->तर्ड्
तण्डि->तण्डी
तत्काल->तात्काल
तथागत->ताथागत
तनक->तानक
तनु->तनू
तन्ति->तान्ति
तन्ती->तान्ति
तन्त्रवाप->तन्त्रावाप
तन्थी->तान्ति
तन्द्रि->तन्द्री
तन्वि->तन्वी
तपोमूर्ति->तपोमूर्ती
तपोरति->तपोराति
तमाल->तामल
तमि->तमी
तमि->तामी
तमिषीचि->तमिषीची
तर्->तार्
तरणि->तरणी
तरस्->तरास्
तरस्थान->तारस्थान
तरि->तरी
तरितर्->तारितर्
तरीतर्->तारितर्
तर्क->तार्क
तर्णि->तार्णि
तर्पण->तर्पर
तर्पिलि->तर्पिली
तलक->तलाक
तलक->तालाक
तलिका->तालिका
ताडि->ताडी
तादयनि->तादायनि
तामि->तामी
ताम्रोष्ठ->ताम्रौष्ठ
तारनाथ->तारानाथ
तालक->तालाक
तालावचर->तालावचार
तालि->ताली
तिक->तीक
तिण्टी->तिण्ठी
तिथि->तिथी
तिन्तिलिका->तिन्तिलीका
तिन्दुकि->तिन्दुकी
तिम->तीम
तिमि->तिमी
तिरस्करिन्->तिरस्कारिन्
तिलखलि->तिलखली
तीक्ष्णलोह->तीक्ष्णलौह
तीरग्रह->तीरग्राह
तीर्थसेनि->तीर्थसेनी
तुडि->तुडी
तुणि->तूणी
तुणि->तूरी
तुण्डि->तुण्डी
तुथ->तूत
तुथ->तूथ
तुन्दि->तुन्दी
तुम्प्->तुम्फ्
तुम्बि->तुम्बी
तुम्बुरु->तुम्बूरु
तुरम्->तूरम्
तुरि->तूणी
तुरि->तूरी
तुरी->तूणी
तुरी->तूरी
तुर्फरि->तुर्फरी
तुर्यवह्->तुर्यवाह्
तुर्व्->तूर्व्
तुर्व->तूर्व
तुला->तूला
तुलाकोटि->तुलाकोटी
तुलाप्रग्रह->तुलाप्रग्राह
तुलि->तुली
तुलि->तूली
तुवि->तुवी
तुविष्टम->तुविष्ठम
तुषारकण->तुषारकर
तुहर->तुहार
तुहिनकण->तुहिनकर
तूणि->तूणी
तूणि->तूरी
तूणिन्->तूरिन्
तूर्णि->तूर्णी
तूलि->तूली
तृणजलायुका->तृणजलायूका
तृणस->तृणाश
तृप्->तृफ्
तृप->तृफ
तृप्ति->तृप्ती
तेन->तैङ
तैत्तिरिक->तैत्तिरीक
तैलक्य->तैलाख्य
तैलद्रोणी->तैलद्रौणी
तैलपक->तैलपाक
तोक->तौक
तोयडिम्ब->तोयडिम्भ
तोलकेशि->तौलकेशि
तोलन->तौलन
त्यद->त्याद
त्यदायनि->त्यादायनि
त्रिंशति->त्रिंशती
त्रिणव->त्रिराव
त्रिपताक->त्रिपथक
त्रिपदिका->त्रिपादिका
त्रिपाट->त्रिपाठ
त्रिपुण्ड्र->त्रिपुण्ढ्र
त्रिपुरभैरवी->त्रिपुराभैरवी
त्रिपुरुष->त्रिपूरुष
त्रिभण्डी->त्रिभाण्डी
त्रिलोहक->त्रिलौहक
त्रिशरण->त्रिसरण
त्रिशानु->त्रिसानु
त्रिसंवत्सर->त्रिसांवत्सर
त्रिसंधि->त्रिसंधी
त्रुटि->त्रुटी
त्रुप्->त्रुफ्
त्रोटि->त्रोटी
त्र्युषण->त्र्यूषण
त्सर->त्सार
थुथुकृत्->थुथूकृत्
थुर्व्->थूर्व्
दंशुक->दंशूक
दंशेर->दंसेर
दकाण->दकार
दक्षि->दक्षी
दक्षि->दाक्षी
दक्षिणत्व->दक्षिणात्व
दक्षिणपूर्व->दक्षिणापूर्व
दक्षिणा->दाक्षिणा
दण्डकल->दण्डकाल
दण्डनायक->दाण्डनायक
दण्डपांशुल->दण्डपांसुल
दण्डय्->दण्डाय्
दण्डवासिक->दाण्डवासिक
दत्त->दत्थ
दत्त->दात्त
ददद->दादद
ददन->दधान
दद्रुघ्न->दद्रूघ्न
दद्रुण->दद्रूण
दद्रुरोगिन्->दद्रूरोगिन्
दधन->दधान
दन्तक->दान्तक
दन्तपवन->दन्तपावन
दन्तशिरा->दन्तसिरा
दन्ति->दन्ती
दन्तोष्ठक->दन्तौष्ठक
दम्->दाम्
दमिन्->दामिन्
दंपति->दम्पती
दंपति->दंपती
दम्भ->दाम्भ
दय्->दाञ्
दयावीर->दायविर
दर्->दाण्
दर->दाण
दरणि->दारणी
दरि->दरी
दरि->दाणि
दरित->दारित
दर्दुर->दार्दूर
दर्दुरक->दार्दुरक
दर्द्रुघ्न->दर्द्रूघ्न
दर्द्रुण->दर्द्रूण
दर्द्रुरोगिन्->दर्द्रूरोगिन्
दर्वि->दर्वी
दर्वि->दार्वी
दर्विक->दर्वीक
दर्शक->दार्शक
दलि->दली
दलि->दाली
दशकण्ठ->दाशकण्ठ
दशति->दशती
दशति->दासति
दशन->दसन
दशनोच्छिष्ट->दशनोच्छिष्ठ
दशपार्श्व->दशापार्श्व
दशमान->दसमान
दशशिरस्->दासशिरस्
दशार्ह->दासर्ह
दशेरक->दशैरक
दहनीय->दाहनीय
दाक्षायणि->दाक्षायणी
दाक्षि->दाक्षी
दार्दुर->दार्दूर
दालि->दाली
दाविककूल->दाविकाकूल
दाशरूप्य->दासरूप्य
दाशशिरस्->दासशिरस्
दाशार्ह->दासर्ह
दाशुर->दाशूर
दिण्ण->दीर्ण
दितिसुत->दितिसूत
दित्यवह्->दित्यवाह्
दिधि->दीधि
दिधिषु->दिधिषू
दिधिषु->दिधीषु
दिनकृत्->दीनकृत्
दिनादि->दीनधी
दिवन्->दीवान्
दिवावसु->दिवावासु
दिह्->दीः
दीक्षापाल->दीक्षाफल
दीदि->दीधि
दीदी->दीधि
दीपावलि->दीपावली
दीर्घपद्->दीर्घपाद्
दुग्धिका->दुग्धीका
दुद->दुध
दुन्दुभि->दुन्दुभी
दुन्दुभिस्वन->दुन्दुभिस्वान
दुरवग्रह->दुरवग्राह
दुराक्रम->दुराक्राम
दुराश->दुरास
दुरोणयु->दुरोणायु
दुर्गटीका->दुर्गाटीका
दुर्गन्धि->दुर्गन्धी
दुर्गल->दुर्गाल
दुर्गसंचर->दुर्गसंचार
दुर्गह->दुर्गाह
दुर्दर->दुर्दार
दुर्मति->दुर्मती
दुर्वचक->दुर्वाछक
दुर्वस->दुर्वास
दुर्वाग्भव->दुर्वाग्भाव
दुलय्->धूलय्
दुलि->दुली
दुलि->दूली
दुश्च्यवन->दुश्च्यावन
दुष्->दूष्
दुष्पार्ष्णिग्रह->दुष्पार्ष्णिग्राह
दुस्->धूस्
दुह्->धुः
दुह्->धूः
दूणश->दूणास
दूणाश->दूणास
दूत->धुत
दून->धुन
दूर->धूर
दूरगत->दूरागत
दूर्व->धुर्व
दूष->धूष
दूषण->धूषर
दूषि->दूषी
दूस->धूश
दूस->धूस
दृक->धृक
दृढक्षत्र->दृढक्षात्र
दृढच्युत->दृढाच्युत
दृढधन्विन्->दृढधान्विन्
दृढनेमि->धृढनेमि
दृढसेन->धृढसेन
दृति->धृती
दृन्->धृङ्
दृशालु->दृशालू
दृशि->दृशी
दृष्टिविष->दृष्टीविष
देवकर्मन्->दैवकर्मन्
देवकृत->दैवकृत
देवतीर्थ->दैवतीर्थ
देवदर्श->देवादर्श
देवदूति->देवदूती
देवनिद्->देवनीद्
देवपुत्र->दैवपुत्र
देवभूत->दैवभूत
देवयजि->देवयाजी
देवयु->देवयू
देवयु->देवायु
देवयु->देवायू
देवयुग->दैवयुग
देवरक्षित->दैवरक्षित
देववत्->देवावत्
देववध->दैववाद
देववीति->देववीती
देवव्रत->देवव्रात
देवसख->दैवसक
देवहूति->देवहूती
देवावृध्->दैवावृध्
देविदास->देवीदास
देवेज्य->दैवेज्य
दैन->धेन
दैवाकरि->दैवाकरी
दोर्ग्रह->दौर्ग्रह
दोलयात्रा->दोलायात्रा
दोस्->दौश्
दोहदोहीय->दोहादोहीय
दौहित्रायण->दौहित्रायाण
द्युति->द्युती
द्युतिमति->द्युतिमती
द्यो->द्यौ
द्योभूमि->द्योभूमी
द्रवि->द्रवी
द्रविण->द्राविण
द्रव्य->द्राव्य
द्रह->द्राह
द्रुणस->द्रुणास
द्रुणि->द्रुणी
द्रुपद->द्रुपाद
द्रुमवल्क->द्रुमवाल्क
द्रुह्->द्रूः
द्रोघ->द्रौघ
द्रोणकजिह्वि->द्रौणकजिह्वि
द्रोणि->द्रोणी
द्रोणीज->द्रौणीज
द्रोणेय->द्रौणेय
द्रौणायन->द्रौणायान
द्वयु->द्वायू
द्वरि->द्वारी
द्वादशकर->द्वादशाकार
द्वादशांश->द्वादशांस
द्वादशीव्रत->द्वादसीव्रत
द्वारपालक->द्वारफलक
द्विगुणय्->द्विगुणाय्
द्वितीयिक->द्वितीयीक
द्वित्र->द्वीत्र
द्विपद्->द्विपाद्
द्विवर्षक->द्विवार्षक
द्विवेशरा->द्विवेसरा
द्वैवर्षिक->द्वैवार्षिक
द्व्यष्टसहस्र->द्व्यष्टसाहस्र
धनदस्तोत्र->धनदास्तोत्र
धनाश्री->धानश्री
धनिक->धानिक
धनिन्->धानिन्
धनुर्वेद->धानुर्वेद
धनुष->धानुष
धनुष्कोटि->धनुष्कोटी
धनेयक->धानेयक
धन्यता->धान्यता
धमनि->धमनी
धरणि->धरणी
धरणि->धारणी
धरापति->धारपति
धरिणि->धारिणी
धर्मधात्री->धर्माधात्री
धर्मभगिनी->धर्मभागिनी
धर्मयु->धर्मायु
धर्माधिकरणिक->धर्माधिकारणिक
धर्म्य->धार्म्य
धवनी->धावनी
धवलय्->धवलाय्
धवलयावनाल->धवलयावानल
धातकि->धातकी
धानका->धानाका
धामशस्->धामसश्
धारणि->धारणी
धारय->धाराय
धारि->धारी
धावनि->धावनी
धिष्ट्य->धिष्ठ्य
धुन्धुरि->धुन्धुरी
धुर->धूर
धुस्तुर->धूस्तुर
धुस्तूर->धूस्तुर
धूण->धूर
धूमपथ->धूमपात
धूम्राक्षि->धूम्राक्षी
धूश्->धूस्
धृति->धृती
धोरित->धौरित
धौति->धौती
ध्यानजप्य->ध्यानजाप्य
ध्रज्->ध्राज्
ध्रु->ध्रू
ध्वंसि->ध्वंसी
ध्वजि->ध्वजी
ध्वनि->ध्वनी
नक्षत्रपथ->नक्षत्रपात
नखारि->नाकारि
नखि->नखी
नखि->नाकी
नगरमर्दिन्->नागरमर्दिन्
नगररक्षिन्->नगाररक्षिन्
नगारि->नागरी
नग्नहु->नग्नहू
नटसूत्र->नाटसूत्र
नड्->नाड्
नडक->नाडक
नति->नाति
नद्->नध्
नदि->नदी
नदीमुख->नदीमूख
नदेयी->नादेयी
नद्धि->नद्धी
नन्दकि->नन्दकी
नन्दि->नन्दी
नन्दि->नान्दि
नन्दिपुराण->नन्दीपुराण
नभनु->नभनू
नम्र->नाम्र
नयन->नायन
नर्->नार्
नरकपाल->नारकपाल
नरकेशरिन्->नरकेसरिन्
नरसिंह->नारसिम्ह
नरहय->नारहय
नराची->नाराची
नराशन->नरासन
नरिष्टा->नरिष्ठा
नरीय->नारीय
नलक->नालक
नलकिनी->नालकिनि
नलिन->नालिन
नवति->नवती
नवशस्य->नवसस्य
नष्टचेष्ट->नष्टचेष्ठ
नष्टि->नष्टी
नहि->नही
नाकुलि->नाकुली
नागवल्लि->नागवल्ली
नागाभिभु->नागाभिभू
नागालाबु->नागालाबू
नाग्नजिति->नाग्नजिती
नाटिन्->नाटीन्
नाडिका->नाडीका
नान्दिकर->नान्दीकर
नाभागदिष्ट->नाभागदिष्ठ
नाभि->नाभी
नारद्वसव->नारद्वासव
नारायणि->नारायणी
नारिष्ठ->नारीष्ट
नार्यङ्ग->नार्याङ्ग
नालि->नाली
नालिजङ्घ->नालीजङ्घ
नालिनी->नालीनी
नावप्रभ्रंशन->नावप्रभ्रांशन
नाविक->नावीक
नाहुषि->नाहुषी
निःशस्->निःशास्
निःशाण->निःसर
निःशूक->निःसूक
निःश्रेणि->निःश्रेणी
निःसरत्व->निःसारत्व
निःसुख->निःसूक
निःस्वन->निःस्वान
निगण->निगर
निचुल->निचूल
निजधृति->निजधृती
निधनता->निधानता
निपुण->निपुर
निबिड->निभिड
नियति->नियती
निरज->निराज
निरय->निराय
निरशन->निराशन
निरसन->निराशन
निराशक->निरासक
निरुदक->निरूदक
निरुपधि->निरुपाधि
निरुपम->निरूपम
निरुपाख्य->निरूपाख्य
निर्गुण->निर्घुण
निर्गुण्टी->निर्गुण्ठी
निर्जरण->निर्झरण
निर्बाध्य->निर्भद्य
निर्मथ->निर्मात
निर्मथ->निर्माथ
निर्माण->निर्मार
निर्वेद->निर्वेध
निलय->निलाय
निलय->नीलाय
निवरण->नीवरण
निवर्तयितव्य->निवर्तयीतव्य
निवारण->नीवरण
निविद्->नीविद्
निवृत->नीवृत
निवेष्य->नीवेष्य
निशा->नीशा
निशित->निसित
निशिता->निशिथा
निशिथ->निसित
निशीथ->निसित
निश्चय->निश्छाय
निश्चिरा->निश्चीरा
निश्वास->निस्वास
निषदन->निषधन
निषादकर्षु->निषादकर्षू
निष्करूष->निष्कारुष
निष्कलि->निष्कली
निष्कुटि->निष्कुटी
निष्क्रम->निष्क्राम
निष्क्रमण->निष्क्रामण
निष्टि->निष्ठी
निष्ट्य->निष्ठ्य
निष्ठुरिक->निष्ठूरिक
निष्पत्ति->नीष्पत्ति
निष्पद->नीष्पद
निष्षह्->निष्षाह्
निसुन्द->निसुन्ध
निस्तन्द्रि->निस्तन्द्री
निह्नुवन->निह्नुवान
नीपातिथि->नीपातीथि
नीरज->नीराज
नीलपोर->नीलपौर
नीलमणि->नीलमाणि
नीललोह->नीललौह
नीलस्कन्दा->नीलस्कन्धा
नीषह्->नीषाह्
नृजित्->नृजीत्
नृति->नृती
नृतु->नृतू
नृपति->नृपती
नृषह्य->नृषाह्य
नेजमेष->नैजमेष
नेपालक->नैपालक
नेमि->नेमी
नेल->नैल
नेष्->नैष्
नेष->नैष
नेष्ट->नैष्ट
नैयमिक->नैयामिक
नैरृति->नैरृती
नैषादि->नैषादी
नोधस्->नोधास्
न्यङ्कुभूरुह->न्यङ्कुभूरूह
न्ययन->न्यायन
न्यायनिबन्ध->न्यायनिभन्ध
पंश्->पंस्
पक्ति->पक्ती
पक्षति->पक्षती
पक्षि->पक्षी
पङ्कग्राह->पङ्खग्राह
पङ्कमण्डुक->पङ्कमण्डूक
पञ्चगत->पञ्चघात
पञ्चचितिक->पञ्चचितीक
पञ्चतप->पञ्चातप
पञ्चबाण->पञ्चभार
पञ्चमुष्टि->पञ्चमुष्टी
पञ्चशर->पञ्चसार
पञ्चशर->पञ्चाशर
पञ्चशस्य->पञ्चसस्य
पञ्चावि->पञ्चावी
पञ्जि->पञ्जी
पट->पठ
पटत्->पठत्
पटि->पटी
पटु->पटू
पट्ट->पट्ठ
पट्टि->पट्टी
पट्टिश->पट्टिस
पणधा->परादा
पणन->परान
पणाया->पराया
पणि->पणी
पतिजुष्ट->पतिजुष्ठ
पतिष्ठ->पथिष्ठ
पत्ति->पत्ती
पत्त्राङ्गुलि->पत्त्राङ्गुली
पत्त्रावलम्बन->पत्त्रावलाम्बन
पदि->पदी
पद्धति->पद्धती
पद्मकर->पद्माकार
पद्मकेशर->पद्मकेसर
पद्माकर->पद्माकार
पनु->पनू
पन्नगकेशर->पन्नगकेसर
पन्नगारि->पन्नागारि
परःश्वस्->परःस्वस्
परक्रान्ति->पराक्रान्ति
परगत->परागत
परतन्त्र->परातन्त्र
परता->परथा
परपुरुष->परपूरुष
परभूत->पराभूत
परभृत->पराभृत
परमपुरुष->परमपूरुष
परमर्षि->परमार्षि
परमार्थसार->परामार्थसार
परमेष्ठि->परमेष्ठी
परवन्त्->परावन्त्
परशुधर->परशुधार
परायति->परायती
परास->पारश
परासु->परासू
परि->परी
परि->पाणी
परि->पारि
परिकर->परिकार
परिक्षित्->पारिक्षित्
परिखा->पाणिका
परिगृहीति->पाणिगृहीती
परिग्रहक->परिग्राहक
परिग्रहक->पाणिग्राहक
परिग्रहवन्त्->पाणिग्राहवन्त्
परिग्रहिन्->पाणिग्राहिन्
परिघात->पाणिगत
परिचपल->पाणिचापल
परिचय->परिचाय
परिचर्य->परिचार्य
परिणमन->परिणामन
परिणय->परिरय
परिणय->परीणाय
परिणय->पारिणाय
परिणयन->परिणायन
परिणह्->पारीणः
परिणाय->परिरय
परिणाय->परीणाय
परिणाय->पारिणाय
परिणाह->परीणाह
परिदा->परिधा
परिदा->परीदा
परिदान->परीधान
परिधान->परीधान
परिधाविन्->परीधाविन्
परिधि->परिधी
परिपदिन्->परिपदीन्
परिपाक->परीपाक
परिपाद->पाणिपाद
परिपान->पारिपान
परिपाल्य->पारिपाल्य
परिपीडा->पाणिपीडा
परिभोग->परीभोग
परिमत्->परिमथ्
परिमत्->पाणिमत्
परिमल->परीमल
परिमित->पाणिमित
परिमोष->परीमोष
परिरक्षक->पारिरक्षक
परिवर्त->परीवर्त
परिवर्ह->पारिवर्ह
परिवाद->परीवाद
परिवाप->परीवाप
परिवाप्य->परीवाप्य
परिवार->परीवार
परिवृत->परीवृत
परिवेत्तर्->परीवेत्तर्
परिवेष->परीवेष
परिव्रज्य->परिव्राज्य
परिव्राजि->परिव्राजी
परिषद्->पारिषद्
परिषेक->परीषेक
परिष्कन्द->परिष्कन्ध
परिष्वजन->परिष्वजान
परिसर->परिसार
परिसर->परीसर
परिसर्प->परीसर्प
परिसर्या->परीसर्या
परिस्कन्द->परिस्कन्ध
परिहास->परीहास
परीक्षित्->पारिक्षित्
परीक्षिति->पारिक्षिती
परीणह्->पारीणः
परु->परू
परुद्वार->परूद्वार
परे->पारे
पर्णकार->पर्णाकर
पर्णरुह्->पर्णरूह्
पर्णसि->पर्णासि
पर्द->पार्द
पर्यवसानिक->पार्यवसानिक
पर्यवस्कन्द->पर्यवस्कन्ध
पर्येहि->पर्येही
पर्ष->पार्ष
पर्षिक->पार्षिक
पल्->पाल्
पलाशक->पालशक
पल्लविक->पाल्लविक
पल्लि->पल्ली
पवनाशनाश->पवनाशनास
पवित->पावित
पशु->पशू
पशुका->पशूखा
पश्चिमानूपक->पाश्चिमानूपक
पाकलि->पाकली
पाञ्चयज्ञिक->पाञ्चयाज्ञिक
पाञ्चलिका->पाञ्चालिका
पाञ्चलोहितिक->पाञ्चलौहितिक
पाञ्चवर्षिक->पाञ्चवार्षिक
पाञ्चालि->पाञ्चाली
पाटलि->पाटली
पाटलिपुत्र->पाटलीपुत्र
पाटित->पाठित
पाटी->पाठि
पाटी->पाठी
पाणि->पाणी
पाणि->पारि
पाणिग्रहणीय->पाणिग्राहणीय
पाणितल->पाणिताल
पाण्डुसोपाक->पाण्डुसौपाक
पातक->पाताक
पाति->पाती
पाति->पाथि
पादगण्डिर->पादगण्डीर
पादशस्->पादशाश्
पादाङ्गुलि->पादाङ्गुली
पानभूमि->पानभूमी
पापक->पापाक
पापपुरुष->पापपूरुष
पायिक->पायीक
पारावताङ्घ्रि->पारावताङ्घ्री
पारावति->पारावती
पाराशरि->पाराशरी
पाराशरिन्->पारासरिन्
पारिकर्मिक->पारिकार्मिक
पारिजात->पारीजात
पारिपाट्य->पारिपाठ्य
पारिश->पारीश
पारुच्छेपि->पारुच्छेपी
पारुष्ण->पारूष्ण
पार्वति->पार्वती
पार्वायनान्तीय->पार्वायानान्तीय
पार्ष्णि->पार्ष्णी
पालहरि->पालहारि
पालि->पाली
पावकि->पावकी
पाशी->पासी
पिच्च्->पिच्छ्
पिच्चा->पिच्छा
पिञ्जल->पिञ्जाल
पिट->पिठ
पिटक->पिठक
पिटाक->पिठक
पिठरक->पीठरक
पिण्डदान->पिण्डादान
पिण्डल->पिण्डाल
पिण्डालु->पिण्डालू
पिनाकि->पिनाकी
पिपिली->पिपीली
पिपीलिकमध्य->पिपीलिकामध्य
पिप्पलि->पिप्पली
पिप्पलिश्रोणि->पिप्पलीश्रोणि
पिप्पिका->पिप्पीका
पिश->पिस
पिशङ्ग->पिसङ्ग
पिशाचि->पिशाची
पिशिताशन->पिशितासन
पिशी->पिसि
पीटिका->पीठिका
पीड->पीढ
पीतवासस्->पीतवासास्
पीति->पीती
पीति->पीथी
पीथि->पीथी
पीलु->पीलू
पुंसक->पुंसाक
पुक्कश->पुक्कस
पुच्छटि->पुच्छटी
पुञ्जि->पुञ्जी
पुञ्जिकस्थला->पुञ्जिकास्थला
पुण्यगन्ध->पुण्यगान्ध
पुत->पुथ
पुतीसृञ्जय->पूतिशृञ्जय
पुत्रिकापूर्वपुत्र->पुत्रिकापूर्वपूत्र
पुनरुक्ति->पुनरुक्ती
पुनर्वसु->पुनर्वसू
पुर->पूण
पुरजित्->पुराजित्
पुरंध्रि->पुरंध्री
पुरय->पूरय
पुरस्->पुरास्
पुराकृत->पूरकृत
पुराणक->पूरणक
पुरारि->पूरणी
पुरि->पूरी
पुरिका->पूरिका
पुरी->पूरी
पुरीकय->पुरीकाय
पुरु->पुरू
पुरुरवस->पुरूरवस
पुरुषकार->पुरुषाकार
पुरुषत्वता->पूरुषत्वता
पुरुषदन्तिका->पुरूषदन्तिका
पुरुषाद्->पूरुषाद्
पुरुषाद->पूरुषाद
पुरुहुत->पुरूहूत
पुरुहूत->पुरूहूत
पुरोगा->पुरोघा
पुरोटि->पूरोटि
पुरोडाश्->पुरोडास्
पुलिक->पूलिक
पुषर्य->पूषर्य
पुष्करशिका->पुष्करशिखा
पुष्कश->पुष्कस
पुष्पवत्->पुष्पावत्
पुष्पवन्त्->पुष्पावन्त्
पूति->पूती
पूतिकरज->पूतीकरज
पूपलिका->पूपालिका
पूर्णक->पूर्णख
पूर्णि->पूर्णी
पूर्वचित्ति->पूर्वचित्ती
पूर्वदेहिक->पूर्वदैहिक
पूर्वभद्रपदा->पूर्वाभाद्रपदा
पूर्ववह्->पूर्ववाह्
पृच्->पृछ्
पृतनाषह्->पृतनाषाह्
पृथिविषद्->पृथिवीषद्
पृथिविसद्->पृथिवीसद्
पृथुजघन->पृथुजाघन
पृथुश्रोणि->पृथुश्रोणी
पृषत->पृषात
पृष्टि->पृष्टी
पृष्टि->पृष्ठि
पृष्टि->पृष्ठी
पृष्टिवह्->पृष्टिवाह्
पेट->पेठ
पेटक->पैठक
पेटाक->पैठक
पेश->पेस
पेशस्->पेसस्
पेषणि->पेषणी
पैङ्गि->पैङ्गी
पैटक->पैठक
पैटाक->पैठक
पोत्रक->पौत्रक
पौरण्टक->पौरण्ठक
पौर्वदेहिक->पौर्वदैहिक
पौलिश->पौलिस
पौष्पि->पौष्पी
प्रख्यस्->प्रख्यास्
प्रगे->प्रगै
प्रचरण->प्रचारण
प्रजनुक->प्रजानुक
प्रजहित->प्रजाहित
प्रज्ञप्ति->प्रज्ञप्ती
प्रज्वलन->प्रज्वालन
प्रज्वलित->प्रज्वालित
प्रणय->प्रणाय
प्रणयन->प्रणयान
प्रणिधि->प्रणिधी
प्रतति->प्रतती
प्रतनु->प्रतनू
प्रतमक->प्रतामक
प्रतरम्->प्रतराम्
प्रतिच्छदन->प्रतिच्छादन
प्रतिधि->प्रतिधी
प्रतिनदि->प्रतिनदी
प्रतिनिधि->प्रतिनिधी
प्रतिपद->प्रतिपाद
प्रतिपुरुषम्->प्रतिपूरुषम्
प्रतिप्राश्->प्रतिप्रास्
प्रतिफल->प्रतिफाल
प्रतिष्ठ->प्रतीष्ट
प्रतिष्ठ->प्रथिष्ट
प्रतिसीरा->प्रतीसीरा
प्रतिहरण->प्रतिहारण
प्रतिहर्तर्->प्रतीहर्तर्
प्रतिहार->प्रातिहर
प्रतीवी->प्रथिवि
प्रतीहार->प्रातिहर
प्रतुद->प्रातुद
प्रत्यक्षता->प्रत्याक्षता
प्रत्यक्षदर्शन->प्रत्याक्षदर्शन
प्रत्यभिज्ञा->प्रत्याभिज्ञा
प्रथ->प्रात
प्रथस्->प्रातश्
प्रथस्->प्रातस्
प्रद->प्राध
प्रदव->प्रदाव
प्रदव->प्रधाव
प्रदा->प्रादा
प्रदाम्->प्रधम्
प्रदाय->प्रादाय
प्रदि->प्रदी
प्रदि->प्रादि
प्रदि->प्राधी
प्रदुह्->प्रादुः
प्रदेशिनी->प्रादेशिनी
प्रदोषक->प्रादोषक
प्रद्रुह्->प्रध्रुह्
प्रध->प्राध
प्रधा->प्रादा
प्रधि->प्रादि
प्रधि->प्राधी
प्रधी->प्रादि
प्रधी->प्राधी
प्रनिक्षण->प्राङीक्षण
प्रपादिक->प्रपादीक
प्रबोध->प्रभोद
प्रबोध->प्राबोध
प्रबोधन->प्रभोदन
प्रभा->प्राबा
प्रभृति->प्राभृती
प्रमति->प्रमती
प्रमति->प्रमथि
प्रमति->प्रमाथी
प्रमय->प्रमाय
प्रमित->प्रमीत
प्रमोद->प्रामोद
प्रमोदक->प्रामोदक
प्रयति->प्रयाति
प्रयस्->प्रायश्
प्रया->प्राया
प्रयुध्->प्रायुध्
प्ररुह्->प्रारुह्
प्रलम्ब->प्रालंब
प्रलम्बन->प्रालम्भन
प्रलम्भ->प्रालंब
प्रलम्भन->प्रालम्भन
प्रव->प्राव
प्रवणि->प्रवणी
प्रवणि->प्रवाणी
प्रवरं->प्रवाणं
प्रवरं->प्रावणं
प्रवह्लि->प्रवह्ली
प्रवाणि->प्रवाणी
प्रवार्य->प्रावण्य
प्रवाल->प्रावाल
प्रवृत्->प्रावृत्
प्रवेणि->प्रवेणी
प्रवेद->प्रवेध
प्रवेश्य->प्रावेश्य
प्रव्रजिका->प्रव्राजिका
प्रव्रजित->प्रव्राजित
प्रशक->प्राशक
प्रशम->प्रशाम
प्रशस्->प्रशास्
प्रशस्त->प्रशास्त
प्रशस्य->प्रशास्य
प्रशाख->प्राशक
प्रशान्->प्रसन्
प्रशुश्रुक->प्रशुस्रुक
प्रष्टि->प्रष्ठी
प्रस्->प्रास्
प्रसङ्ग->प्रसङ्घ
प्रसरणि->प्रसरणी
प्रसरणि->प्रसारणी
प्रसह्->प्राशः
प्रसह्->प्रासः
प्रसाद्->प्रसाध्
प्रसादिन्->प्रसाधिन्
प्रसाद्य->प्रासाद्य
प्रसाध्य->प्रासाद्य
प्रसाह्->प्राशः
प्रसाह्->प्रासः
प्रस्तरण->प्रास्तरण
प्रस्थ->प्रास्त
प्रहसित->प्रहासित
प्रहाणि->प्रहारि
प्रहुत->प्राहूत
प्रहेलि->प्रहेली
प्रह्लाद->प्राह्लाद
प्रह्वलीका->प्रह्वालिका
प्राञ्जलि->प्राञ्जली
प्राण्->प्रार्
प्राणधर->प्राणाधार
प्राणधार->प्राणाधार
प्राणप्रिय->प्राणाप्रिय
प्राणाह->प्राराह
प्रातिपदिक->प्रातिपादिक
प्रातिपीय->प्रातीपीय
प्रातिपेय->प्रातीपेय
प्रान्तर->प्रान्तार
प्रायोपविष्ट->प्रायोपविष्ठ
प्राश्->प्रास्
प्राशित्रहरण->प्राशित्राहरण
प्राशिन्->प्रासिन्
प्राशुक->प्रासुक
प्राश्य->प्रास्य
प्रियक->प्रियाक
प्रियंकर->प्रियंकार
प्रीति->प्रीती
प्रुष्->प्रूष्
प्रेण्->प्रेर्
प्रेणि->प्रेरी
प्रेष->प्रैष
प्रोद्दण्ड->प्रोद्दाण्ड
प्रोह्यपदि->प्रोह्यपादि
प्रौढि->प्रौढी
प्लक्षप्रस्रवण->प्लक्षप्रास्रवण
प्लाक्षि->प्लाक्षी
फट्->फाट्
फणी->फारि
फणी->फारी
फलकेशर->फलकेसर
फलग्रहि->फलग्राही
फलचमस->फालचमस
फलय->फलाय
फलि->फली
फलि->फालि
फलि->फाली
फलिका->फालिका
फलित->फालित
फलोदक->फलौदक
फल्गु->फल्गू
फाणि->फारि
फाणि->फारी
फाल्गुनि->फाल्गुनी
फुत्कर->फूत्कार
फुत्कार->फूत्कार
फुत्कार्य->फूत्कार्य
फुत्कृति->फूत्कृति
फेनिल->फेनील
बज->भज
बट्->बठ्
बद्->भद्
बदरि->बदरी
बद्धप्पि->बद्धाप्पि
बद्व->बध्व
बद्व->बाध्व
बध्->भद्
बन्दि->बन्दी
बन्दि->बन्धि
बन्दिग्राह->बन्दीग्रह
बन्ध->भन्द
बन्धु->बन्धू
बन्धुक->भन्धुक
बन्धूक->भन्धुक
बन्ध्र->भन्द्र
बबकाण->बबकार
बबर->बभार
बभ्रवी->बाभ्रवी
बम्बा->भम्भा
बम्भारव->भम्भराव
बर्ब्->भर्भ्
बर्बर->बार्बर
बर्बरक->बार्बरक
बर्बरि->बर्बरी
बर्हस्->बार्हस्
बलग्र->बालाग्र
बलल->बलाल
बलहन्->बालहन्
बलाग्र->बालाग्र
बलावस्थ->बालावस्थ
बलि->बली
बलि->बालि
बलि->बाली
बलिक->बलीक
बलिक->बालिक
बलिका->बालिका
बलिन्->बालिन्
बलिमन्->बलिमान्
बलिहन्->बालिहन्
बल्लाल->भल्लाल
बव->बाव
बष्कयणी->बष्कयाणी
बह्->बाह्
बह्->भः
बह्->भाः
बहि->बही
बहिर्भव->बहिर्भाव
बहु->बाहू
बहुकण्टक->बाहुकण्टक
बहुकरणीय->बहुकारणीय
बहुत्र->बाहुत्र
बहुधार->बहूदर
बहुपुत्र->बाहुपुत्र
बहुफल->बाहुफल
बहुमल->बहुमाल
बहुमाय->बाहुमय
बहुवत्->बाहुवत्
बहुविद्य->बहुविध्य
बह्लि->बाह्लि
बाड्->भड्
बाणता->भरता
बाणवन्त्->भरवन्त्
बाध्->भद्
बाध->भद
बाधबुद्धिप्रतिबन्धकताविचार->बाधबुद्धिप्रतिभन्धकताविचार
बान्धुक->भन्धुक
बालचर्य->बालाचार्य
बालतन्त्र->बालातन्त्र
बालरामायण->बालरामायाण
बालायनि->बालायनी
बास->भस
बाहु->बाहू
बाहूबाहवि->बाहूबाहावि
बिटक->बिठक
बिटक->बीटक
बिश->बीश
बिस->बीश
बिसाकर->बिसाकार
बुक्कन्->बूक्कन्
बुन्द->बुन्ध
बृहत्काश->बृहत्कास
बृहन्नट->बृहन्नाट
बैन्दवि->बैन्दवी
बोधकर->बोधकार
ब्रध्नश्व->ब्रध्नाश्व
ब्रह्मकल्प->ब्राह्मकल्प
ब्रह्मदान->ब्रह्मधन
ब्रह्मदान->ब्रह्मधान
ब्रह्मदेय->ब्राह्मदेय
ब्रह्मन्->ब्राह्मन्
ब्रह्मपथ->ब्रह्मपात
ब्रह्मपद->ब्रह्मपाद
ब्रह्मपुराण->ब्राह्मपुराण
ब्रह्मबन्धु->ब्रह्मबन्धू
ब्रह्मयोनि->ब्रह्मयोनी
ब्रह्मविद्याभरण->ब्रह्मविद्याभारण
ब्रह्मवेदि->ब्रह्मवेदी
ब्रह्मसिद्धान्त->ब्राह्मसिद्धान्त
ब्रह्मस्व->ब्रह्मास्व
ब्रह्महुत->ब्राह्महुत
ब्रह्माणी->ब्राह्मणि
ब्रह्माणी->ब्राह्मणी
ब्रह्माहुत->ब्राह्महुत
ब्रह्माहुति->ब्रह्माहूति
ब्राह्मणता->ब्राह्मणाता
ब्राह्मणिक->ब्राह्मणीक
ब्राह्मिका->ब्राह्मीका
भक्तरुचि->भक्तारुचि
भक्ति->भक्ती
भक्ष्यालाबु->भक्ष्यालाबू
भगदा->भागधा
भगदेव->भगदैव
भगनन्दा->भगानन्दा
भगाधान->भागधान
भङ्गि->भङ्गी
भणन->भणान
भणनीय->भरनीय
भण्डर->भण्डार
भद्रकार->भद्राकर
भद्रकार->भद्राकार
भद्रयान->भद्रायन
भद्रश्रिय->भद्रश्रीय
भद्रोदनी->भद्रौदनी
भरणि->भरणी
भरतमल्लिक->भरतमल्लीक
भरुज->भरूज
भर्ब्->भर्भ्
भवन्ति->भवन्ती
भस्त्रफला->भस्त्राफला
भागदा->भागधा
भागवति->भागवती
भाणिका->भारिका
भाण्डि->भाण्डी
भाण्डिक->भाण्डीक
भात्वक्षस्->भात्वक्षास्
भारय->भाराय
भारवि->भारवी
भारि->भारी
भार्गि->भार्गी
भावयु->भावयू
भास्कर->भास्खर
भास्करेष्टा->भास्कारेष्टा
भिदा->भीदा
भीमाकर->भीमाकार
भीरु->भीरू
भुजज्या->भूजज्या
भुशुण्डि->भुशुण्डी
भुषुण्डि->भुषुण्डी
भूकश्यप->भूकाश्यप
भूजम्बु->भूजम्बू
भूमिजम्बु->भूमिजम्बू
भूमिभृत्->भूमीभृत्
भूरि->भूरी
भूरिषह्->भूरिषाह्
भूर्जकण्टक->भूर्जकण्ठक
भूर्भुव->भूर्भूव
भृकुंश->भृकुंस
भृकुटि->भृकुटी
भृङ्गरिटि->भृङ्गरीटि
भृङ्गारि->भृङ्गारी
भृङ्गि->भृङ्गी
भृङ्गिरिटि->भृङ्गिरीटि
भृति->भृती
भृष्टि->भृष्टी
भेरि->भेरी
भैक्षक->भैक्षाक
भैक्षचरण->भैक्षाचरण
भैमि->भैमी
भोट->भौट
भोलि->भौलि
भोलि->भौली
भौरिकि->भौरिकी
भौलिङ्गि->भौलिङ्गी
भ्रंश->भ्रंस
भ्रकुंश->भ्रकुंस
भ्रकुटि->भ्रकुटी
भ्रमरक->भ्रामरक
भ्रमि->भ्रमी
भ्रातृश्वशुर->भ्रातृश्वसुर
भ्रुकुंश->भ्रुकुंस
भ्रुकुंश->भ्रूकुंस
भ्रुकुटि->भ्रुकुटी
भ्रुकुटि->भ्रूकुटी
भ्रुकुटीमुख->भ्रूकुटीमुख
भ्रूकुंश->भ्रूकुंस
भ्रूकुटि->भ्रूकुटी
मक्कुल->मक्कूल
मक्षु->मक्षू
मघवन्->मघवान्
मचर्चिका->मचर्छिका
मञ्जरि->मञ्जरी
मञ्जि->मञ्जी
मञ्जु->मञ्जू
मटची->मठची
मणि->मणी
मणिव->मणीव
मणिसोपान->मणिसौपान
मण्ट्->मण्ठ्
मण्डलवट->मण्डलवाट
मण्डलिक->मण्डलीक
मति->मती
मतिविद्->मतीविद्
मत्सगण्ट->मत्सगण्ठ
मत्स्याशन->मत्स्यासन
मदनपाल->मदनफल
मदि->मदी
मद्यपाशन->मद्यपासन
मधुक->मधूक
मधुपाणि->मधुपारी
मधुमति->मधुमती
मधुयष्टि->मधुयष्टी
मधुलिका->मधूलिका
मधुशुक्त->मधुसूक्त
मध्यमपुरुष->मध्यमपूरुष
मध्यमादि->मध्यमादी
मनःशिला->मनःसिला
मनन->मनान
मन्ति->मन्थि
मन्त्रार्थदीप->मन्त्रार्थादीप
मन्त्रि->मन्त्री
मन्दन->मन्दान
मन्दोच्च->मन्दोच्छ
मरीचि->मरीछि
मरीचि->मारीची
मरीची->मरीछि
मरीची->मारीची
मरु->मरू
मरुन्ध->मरून्ध
मरुव->मरूव
मर्त->मार्त
मलकूट->मालाकुट
मलवदेश->मालवदेश
मलवन्त्->मलावन्त्
मलाका->मालका
मलि->माली
मल्लारि->मल्लारी
मश->मस
मशक->मशाक
मशककुटि->मशककुटी
मषि->मषी
मषि->माषी
मसि->मसी
मसि->मासी
मह->माह
महदाशा->महादशा
महन्->महान्
महन->महान
महसोण->महासौर
महाकपि->महाकापि
महाकपोल->महाकापोल
महाकर्णि->महाकर्णी
महाग्रह->महाग्राह
महाजम्बु->महाजम्बू
महादान->महाधान
महाधन->महाधान
महानन्दि->महानन्दी
महापान->महाफन
महाप्रसाद->महाप्रासाद
महाप्रस्थानिक->महाप्रास्थानिक
महामण्डलिक->महामण्डलीक
महामति->महामती
महामूर्ति->माहामूर्ति
महायम->माहयाम
महायाम->माहयाम
महारव->महाराव
महारात्रि->महारात्री
महालीलसरस्वती->महालीलासरस्वती
महावस्तु->महावास्तु
महाविज्ञ->महावीज्य
महाव्रतिक->माहाव्रतिक
महाशान्ति->महाशान्ती
महाशीता->महासिता
महाशोण->महासौर
महाशौषिर->महासौषिर
महिदास->महीदास
महिमन्->महिमान्
महीरत->महीरथ
महोदर->महोदार
महौषधि->महौषधी
माक्षिक->माक्षीक
माटियारि->माटीयारि
माड->माढ
माणिका->मारिका
माण्डूकायनि->माण्डूकायनी
माण्डूकि->माण्डूकी
माति->माती
मातुलङ्ग->मातुलाङ्ग
मातुलि->मातुली
माद्य->माध्य
माद्री->माध्रि
माध्यंदिनि->माध्यंदिनी
मानस->मानास
मानसिक->मानसीक
मानिन्ध->मानीन्ध
मायूरि->मायूरी
मारि->मारी
मारीचि->मारीची
मारुति->मारुती
मार्जारि->मार्जारी
मार्ष्टि->मार्ष्ठि
मालाधर->मालाधार
मालि->माली
माषि->माषी
मिघ्->मीग्
मित->मिथ
मित->मीत
मितभुक्त->मितभूक्त
मित्रक्रु->मित्रक्रू
मित्रशिस्->मित्रशीस्
मित्रिय->मित्रीय
मिथु->मिथू
मिशि->मिशी
मिशि->मिसी
मिश्र->मिस्र
मिसि->मिसी
मुकुलय्->मुकुलाय्
मुक्ताप्रसू->मुक्ताप्रासू
मुट्->मुठ्
मुट->मुठ
मुट->मूट
मुण्->मूर्
मुण्ट्->मूण्ठ्
मुण्ठ्->मूण्ठ्
मुथशिल->मुथशील
मुदकर->मुदाकर
मुदर->मुदार
मुद्गष्ट->मुद्गष्ठ
मुनि->मुनी
मुमुचान->मुमूचान
मुर्->मूर्
मुरुण्ड->मुरूण्ड
मुष्टि->मुष्टी
मुह्->मूः
मूर्ति->मूर्ती
मूलकेशर->मूलकेसर
मृLईक->मृलिक
मृगनाभि->मृगनाभी
मृच्->मृछ्
मृडानी->मृढानी
मृदु->मृधु
मृदू->मृधु
मेघरव->मेघाराव
मेघराव->मेघाराव
मेठि->मेठी
मेडि->मेढि
मेथि->मेथी
मेदिन्->मेधिन्
मेदिनि->मेदिनी
मेधि->मेधी
मेन->मैन
मेनाद->मैनाद
मेषाक्षिकुसुम->मेषाक्षीकुसुम
मैत्रायणि->मैत्रायणी
मैत्रि->मैत्री
मोघोलि->मोघोली
मोचि->मोची
मोण->मोर
मोणक->मोरक
मोदक->मोदाक
मोरट->मौरट
मोष->मौष
मौक्तिकावलि->मौक्तिकावली
मौजवत->मौजावत
मौलि->मौली
यजमान->याजमान
यज्ञदत्त->याज्ञदत्त
यज्ञानुकाशिन्->यज्ञानूकाशिन्
यज्ञायज्ञिय->यज्ञायज्ञीय
यत->यथ
यति->यती
यतुका->यतूका
यत्कारणम्->यात्कारणम्
यथा->याता
यथा->याथा
यथातथ्यम्->याथातथ्यम्
यथातथ्येन->याथातथ्येन
यथाबलम्->यथाबालम्
यथाश्रद्धम्->यथाश्राद्धम्
यथेतम्->यथैतम्
यद->याद
यदि->यदी
यन्त्रप्रकाश->यन्त्रप्राकाश
यन्त्रशर->यन्त्रसार
यमकोटि->यमकोटी
यमघण्ट->यमघण्ठ
यमानुग->यामानुग
यमुना->यामुना
ययावर->यायवर
ययि->ययी
यवनी->यावानी
यवाद्->यावद्
यवानी->यावानी
यश->यस
यष्टि->याष्टि
यष्टिक->याष्टिक
यष्टी->याष्टि
यष्टीक->याष्टिक
यस्->यास्
यहु->यहू
याज्ञसेनि->याज्ञसेनी
यातलराय->यातलाराय
यामुनेष्टक->यामुनेष्ठक
युति->यूथी
युवखलति->युवखलती
युवति->युवती
युवद्देवत्य->युवद्धेवत्य
यूति->यूथी
यूनि->यूनी
योगचिन्तामणि->योगचिन्तामणी
योगरूढ->योगारूढ
योगि->योगी
योनि->योनी
रक->रख
रक्तपदी->रक्तपादी
रक्तराजि->रक्तराजी
रक्ताक्षि->रक्ताक्षी
रक्तातिसार->रक्तातीसार
रक्ति->रक्ती
रक्षणि->रक्षणी
रक्षि->रक्षी
रङ्गजीवक->रङ्गाजीवक
रजि->रजी
रज्जु->रज्जू
रणक्षोणि->रणक्षौणि
रतज्वर->रथज्वर
रति->रती
रतोद्वह->रतोद्वाह
रथकर->रथाकार
रथकार->रथाकार
रथान्तर->राथन्तर
रथिन्->रातिन्
रथीतर->राथितर
रद->रध
रद्द->रद्ध
रमण->रमाण
रमापति->रामपति
रम्ब्->रंभ्
रयस्->रायस्
रवण->रवाण
रवथ->रावत
रविलोह->रविलौह
रशना->रसना
रस->राश
रसमञ्जरी->रासमञ्जरी
रसवह->रसावह
रह्->राः
रह->राह
रहसनन्दिन्->रहसानन्दिन्
राग->राघ
रागषाडव->रागषाढव
राजकशेरु->राजकसेरु
राजदार->राजाधर
राजधानी->राजादनी
राजन->राजान
राजनि->राजनी
राजशफर->राजसफर
राजशय्या->राजशाय्या
राजावलि->राजावली
राणक->राणाक
राणि->राणी
रात->राथ
रात्रिचर->रात्रिचार
रात्रिमणि->रात्रिमाणि
राधि->राधी
रामकिरी->रामकीरी
रामगिरि->रामगिरी
रामधर->रामाधार
रामि->रामी
रायण->रायाण
रावणि->रावणी
राशि->राशी
रिटि->रीटि
रीति->रीती
रु->रू
रुंश्->रुंस्
रुक्मि->रुक्मी
रुद्रिय->रुद्रीय
रुप्->रूप्
रूपशस्->रूपसस्
रेव->रैव
रेवति->रेवती
रेवति->रैवती
रोचस्->रौचस्
रोट->रौट
रोड->रौड
रोमराजि->रोमराजी
रोशंसा->रोसंसा
रोषण->रोषाण
रोहिणिका->रोहिणीका
रौण->रौर
रौद्रि->रौद्री
लक->लाख
लकुल->लाकुल
लक्षपुर->लाक्षापुर
लख->लाख
लग्->लघ्
लघु->लघू
लघुच्छेद्य->लघूच्छेद्य
लट्->लाट्
लट्य्->लाट्य्
लब्धनामन्->लब्धानामन्
लम्बोष्ठ->लम्बौष्ठ
ललित->ललिथ
ललितक->लालितक
ललितिक->ललीतिक
लवली->लावली
लवाणक->लावणक
लसिका->लासिका
लसीका->लासिका
लहरि->लहरी
लाक्षाप्रसादन->लाक्षाप्रसाधन
लाङ्गलि->लाङ्गली
लाङ्गुलिनी->लाङ्गूलिनी
लाबु->लाबू
लावेरिणि->लावेरिणी
लिङ्->लीङ्
लिह्->लीः
लुप्->लूप्
लुब्धता->लुब्धाता
लुश->लुस
लेक->लैख
लेख->लैख
लेखनि->लेखनी
लैङ्गिक->लैङ्गीक
लोकाभिलषित->लोकाभिलाषित
लोचनपथ->लोचनपात
लोचनपथ->लोचनापात
लोणिका->लोणीका
लोमकिन्->लोमाकिन्
लोमन->लौमन
लोष्टक->लोष्ठक
लोष्टधर->लोष्ठधर
लोष्टाक्ष->लोष्ठाक्ष
लोहर->लोहार
लोहि->लोही
लोहितक->लौहितक
लोहितध्वज->लौहितध्वज
लोहितायनि->लोहितायनी
लोहिताश्व->लौहितास्व
लौहिताश्व->लौहितास्व
वंशिवाद्य->वंशीवाद्य
वक्->वाक्
वक्रि->वक्री
वक्ष्->वाक्ष्
वक्षी->वाक्षि
वख्->वाक्
वङ्ग्->वङ्घ्
वङ्गाल->वाङ्गाल
वङ्घ->वन्ग
वच्->वाछ्
वच->वाछ
वचनकर->वचनकार
वचस्->वाचस्
वचसांपति->वाचसाम्पति
वचाचार्य->वछाचार्य
वचि->वाछि
वज्रधर->वज्रधार
वज्रवह्->वज्रवाह्
वज्रशुचि->वज्रसूची
वज्रसूचि->वज्रसूची
वज्राकर->वज्राकार
वञ्चक->वाञ्छक
वञ्चक->वाञ्छाक
वञ्चन->वाञ्छन
वञ्चनीय->वाञ्छनीय
वञ्चिन्->वाञ्छिन्
वञ्चुक->वञ्चूक
वञ्च्य->वाञ्छ्य
वट->वठ
वटि->वठि
वटि->वाटि
वटि->वाटी
वटी->वठि
वटी->वाटि
वटी->वाटी
वट्य->वाठ्य
वण्टाल->वण्ठाल
वतरणी->वातारणि
वतायन->वातयान
वति->वाती
वद्->वाध्
वद->वाध
वदन->वाधन
वदन्ति->वदन्ती
वदावद->वधावध
वदि->वधी
वदि->वादी
वदितर्->वादितर्
वध्->वाध्
वध->वाध
वधा->वाधा
वधिक->वाधिक
वधिन्->वाधिन्
वधु->वाधु
वधु->वाधू
वधू->वाधु
वधू->वाधू
वध्रि->वध्री
वध्रि->वाध्री
वन्->वाङ्
वन्->वान्
वनमक्षिका->वनमाक्षिका
वनराजि->वनराजी
वनवास->वनावास
वनस->वनाश
वनि->वनी
वनोद्देश->वनोद्देस
वन्ति->वान्ती
वन्द्यता->वन्ध्यता
वन्य->वान्य
वप्पिय->वप्पीय
वप्रि->वप्री
वमि->वमी
वमि->वामी
वरण->वरर
वरणक->वारणक
वरणसी->वरणाशी
वरणसी->वराणसी
वरणसी->वारणसी
वरणसी->वारणासी
वरतनु->वरतनू
वरत्रा->वारत्रा
वरदान->वरधान
वरयुवति->वरयुवती
वरसान->वाणासन
वरारक->वारणक
वराशि->वरासि
वराशि->वरासी
वरासन->वाणासन
वराहकन्द->वाराहकन्द
वराहपुराण->वाराहपुराण
वराहसंहिता->वाराहसंहिता
वराहाश्व->वाराहाश्व
वरिन्->वाणिन्
वरुक->वरूक
वरुक->वारुक
वरुणदेव->वरुणदैव
वरेण->वारेण
वर्ग->वर्घ
वर्गप्रशंसिन्->वर्गप्रशांसिन्
वर्ज्य->वार्ज्य
वर्णतूलि->वर्णतूली
वर्णि->वर्णी
वर्णिक->वार्णिक
वर्त->वार्त
वर्तनि->वर्तनी
वर्ति->वर्ती
वर्तिक->वार्तीक
वर्तिका->वार्तिका
वर्त्र->वार्त्र
वर्धकि->वर्धकी
वर्मिक->वार्मिक
वर्श्मन्->वर्स्मन्
वर्ष्->वार्ष्
वर्षकर->वर्षाकार
वर्षाम्भःपारणव्रत->वर्षाम्भःपारणाव्रत
वर्ष्म->वार्ष्म
वलक->वलाक
वलक->वालाक
वलन->वलान
वल्लर->वल्लार
वल्लरि->वल्लरी
वल्लरि->वल्लारी
वल्लिदूर्वा->वल्लीदूर्वा
वल्लिशूरण->वल्लिसूरण
वशत्व->वशात्व
वशन->वसान
वशाति->वसती
वशि->वसी
वशी->वसी
वसति->वसती
वसन->वसान
वसावि->वसावी
वसि->वसी
वस्ति->वस्ती
वस्वोकसारा->वस्वौकसारा
वह्->वाः
वाकिनि->वाकिनी
वाक्केलि->वाक्केली
वागुण->वागुर
वागुलि->वागुली
वाच्->वाछ्
वाच->वाछ
वाचनिक->वाचनीक
वाचाट->वाचाठ
वाची->वाछि
वाजप्य->वाजाप्य
वाजश्रवस्->वाजस्रवस्
वाट्य->वाठ्य
वाणकि->वारकि
वाणकि->वारकी
वाणरसी->वारणसी
वाणरसी->वारणासी
वाणारसी->वारणसी
वाणारसी->वारणासी
वातकि->वातकी
वातवन्त्->वातावन्त्
वातहत->वाताहत
वातहर->वाताहार
वातापि->वातापी
वाति->वाती
वातुलि->वातूली
वाद->वाध
वादन->वाधन
वादि->वादी
वादिक->वाधिक
वादिन्->वाधिन्
वाधुक्य->वाधूक्य
वान्ति->वान्ती
वामाक्षि->वामाक्षी
वामोरु->वामोरू
वारणबुसा->वारणबूसा
वारवाणि->वारवाणी
वारुणि->वारुणी
वार्तिक->वार्तीक
वार्त्ताहर->वार्त्ताहार
वालक->वालाक
वालुका->वालूका
वालुकि->वालुकी
वासत->वासात
वासवि->वासवी
वासुकि->वासुकी
वाहस्->वाहास्
वाहिक->वाहीक
विंशतिम->विंसतिम
विकसन->विकाशन
विकुर्वण->विकुर्वाण
विकृति->विकृती
विक्रयिक->विक्रायिक
विगम->विगाम
विगाथा->विघाता
विग्रह->विग्राह
विचय->विछाय
विचि->विची
विजन->विजान
विजनता->विजानता
विजयपाल->विजयफल
विजर्जर->विझर्झर
विज्ञप्ति->विज्ञाप्ति
वितति->वितती
वितति->वितथी
वितत्य->वितथ्य
वितर्दि->वितर्दी
वितर्द्धि->वितर्द्धी
वितल->विताल
वित्तनाथ->वित्तानाथ
विदर्व्य->विदार्व्य
विदाय->विधाय
विदारक->विधारक
विदारि->विदारी
विदि->विधी
विदु->विधू
विदुरता->विदूरता
विद्र->विध्र
विद्वंस्->विध्वंस्
विधव्->विधाव्
विधि->विधी
विधु->विधू
विधुति->विधूति
विनस->विनास
विनाश->विनास
विनिवारण->विनीवरण
विन्ध्यावलि->विन्ध्यावली
विपणि->विपणी
विपणि->विपरी
विपदी->विपादी
विपलाश->विफलाश
विभु->विभू
विभुप्रमित->विभुप्रामित
विभुमन्त्->विभूमन्त्
विभ्रंश->विभ्रंस
विमनस्->विमानस्
विमर्द->विमर्ध
वियोनि->वियोनी
विरजस्->विरजास्
विरजस->विराजस
विरत->विरात
विरति->विरथी
विरथ->विरात
विरमण->विरामण
विरल->विराल
विरुज->विरूज
विरुदावलि->विरुदावली
विरेपस्->विरेफस्
विलय->विलाय
विलयन->विलायन
विलोचनपथ->विलोचनपात
विलोटन->विलोठन
विवस्->विवास्
विवस्वन्->विवस्वान्
विविक्ति->विविक्ती
विवेकचूडामणि->विवेकचूडामणी
विशब्द->विशब्ध
विशिका->विशिखा
विशुण्डि->विशुण्डी
विश्रमण->विश्रामण
विश्रवण->विश्रावण
विश्रि->विश्री
विश्रुति->विश्रुती
विश्वकद्रु->विश्वकद्रू
विश्वचर्षणि->विश्वचर्षणी
विश्वध->विस्वाद
विश्वधर->विस्वधार
विश्वधार->विस्वधार
विश्वशंभु->विश्वशम्भू
विश्वसामन्->विश्वासामन्
विश्वस्फटिक->विश्वस्फाटिक
विश्वाची->विस्वची
विश्वाधार->विस्वधार
विष्->वीष्
विषणि->विषाणी
विषधर->विषधार
विषमचतुरश्र->विषमचतुरस्र
विषमय->विषमाय
विषय->विषाय
विषवल्लि->विषवल्ली
विषित->वीषित
विषु->विषू
विष्कम्भिन्->विष्कांभिन्
विष्टरश्रवस्->विष्टरस्रवस्
विष्टि->विष्टी
विष्णुपद->विष्णुपाद
विष्पुलिङ्गक->विष्फुलिङ्गक
विष्वञ्च्->विष्वाञ्च्
विस्रव->विस्राव
विहर->विहाण
विहर->वीहार
विहव्य->विहाव्य
विहार->वीहार
वीचि->वीची
वीटि->वीटी
वीणा->वीरा
वीणावाद->वीरवाद
वीणिन्->वीरिन्
वीति->वीथी
वीथि->वीथी
वीरचर्य->वीराचार्य
वीरणक->वीराणक
वृक्षमय->वृक्षामय
वृजि->वृजी
वृत्तिकर->वृत्तिकार
वृत्रतुर्->वृत्रतूर्
वृद्धगर्ग->वृद्धगार्ग
वृद्धि->वृद्धी
वृषण->वृषाण
वृषय->वृषाय
वृषवाह->वृषावाह
वृषागिर्->वृषागीर्
वृष्टि->वृष्टी
वृष्णि->वृष्णी
वेगसर->वेगसार
वेट->वेठ
वेणा->वैरा
वेणि->वेरि
वेणि->वैणि
वेणि->वैरी
वेणिक->वैरिक
वेणिमाधव->वेणीमाधव
वेणी->वेरि
वेणी->वैणि
वेणी->वैरी
वेणु->वैणु
वेणुवीणाधरा->वेणुवीणाधारा
वेत->वेथ
वेत्र->वैत्र
वेत्रकीय->वैत्रकीय
वेदगुप्त->वेधगुप्त
वेदत्व->वैधत्व
वेददीप->वेदाधिप
वेदनीय->वेधनीय
वेदमुख्या->वेधमुख्या
वेदशिरस्->वेदाशिरस्
वेदश्रुति->वेदश्रुती
वेदसिनी->वैदसिनी
वेदस्मृति->वेदस्मृती
वेदि->वेदी
वेदि->वेधी
वेदि->वैदी
वेदिक->वेदीक
वेदिक->वैधिक
वेद्या->वेध्या
वेद्या->वैद्या
वेल->वैल
वेश->वेस
वेश->वैश
वेशक->वैसाख
वेशवार->वैशवण
वेषश्रि->वेषश्री
वेष्क->वैष्क
वेसवार->वैशवण
वैखानसि->वैखानसी
वैणिक->वैरिक
वैतरणि->वैतरणी
वैदर्भि->वैदर्भी
वैदर्व्य->वैदार्व्य
वैदि->वैदी
वैदिक->वैधिक
वैदेहि->वैदेही
वैयल्कश->वैयल्कस
वैरकरण->वैरकारण
वैरत->वैरथ
वैराटि->वैराटी
वैराट्या->वैराठ्या
वैरि->वैरी
वैरिणि->वैरिणी
वैशाख->वैसाख
वैशालि->वैशाली
वैशिष्ट्य->वैशिष्ठ्य
वैश्वामित्रि->वैश्वामित्री
वैष्टपुरेय->वैष्ठपुरेय
वैहति->वैहती
वैहलि->वैहाली
वोड्र->वौड्र
व्यक्ति->व्यक्ती
व्यति->व्यती
व्याघ्रपद्->व्याघ्रपाद्
व्यापृत->व्यापृथ
व्यालि->व्याली
व्युत->व्यूत
व्युष्टिमन्त्->व्युष्ठिमन्त्
व्रजिन्->व्राजिन्
व्रण->व्राण
व्रतति->व्रतती
व्रतदान->व्रतादान
व्रतपति->व्रातपती
व्रातपति->व्रातपती
व्रिश्->व्रीस्
व्रीहि->व्रीही
शकटायन->शाकटयन
शकटि->शकटी
शकटिका->शाकटिका
शकमय->शाखामय
शकर->शाकार
शकलिन्->शाकलिन्
शकार->शाकार
शकुनि->शकुनी
शकुनि->शाकुनि
शकुल->शाकुल
शक्कर->शाक्कर
शक्ति->शक्ती
शक्रि->शाक्री
शङ्क->शाङ्क
शंकर->शंखण
शंकरीय->शांकरीय
शङ्का->शङ्खा
शङ्कुचि->शाङ्कुची
शङ्ख->शाङ्क
शङ्खिक->शाङ्किक
शटि->शठी
शटि->शाटि
शटि->शाटी
शटी->शठी
शटी->शाटि
शटी->शाटी
शण्->शार्
शणक->शारक
शण्डाकी->शाण्डाकी
शतखण्ड->शतखाण्ड
शतद्रु->शतद्रू
शतद्रुति->शतद्रुती
शतपद्->शतपाद्
शतपादी->शतापदी
शतमख->शातमख
शतवार->शतावर
शतोदर->शातोदर
शनक->शानक
शनकावलि->शनकावली
शनि->शानी
शंतनुत्व->शांतनुत्व
शन्त्व->शान्त्व
शबरक->शाबरक
शम->शाम
शमिक->शमीक
शम्ब->शाम्ब
शम्बर->शम्भर
शम्बर->शाम्भर
शम्बु->शम्बू
शम्बु->शम्भु
शम्बु->शम्भू
शम्बु->शाम्बु
शम्बु->शांबु
शम्भ->शाम्ब
शंभव->शाम्बव
शंभव->शाम्भव
शंभु->शम्भू
शंभु->शाम्बु
शंभु->शांबु
शंभुनाथ->शम्भूनाथ
शंभू->शाम्बु
शंभू->शांबु
शयन->शायन
शयान->शायन
शर्->शार्
शरक->शारक
शरण->शारण
शरणि->शरणी
शरणि->शरारी
शरता->शारता
शरधान->शरादान
शरधि->शारदी
शराक->शारक
शरारि->शरारी
शरालि->शराली
शरि->शाणी
शरि->शारी
शरी->शाणी
शरी->शारी
शरीरस्थान->शारीरस्थान
शर्मण्य->शार्मण्य
शर्मर->शार्मण
शर्यणावन्त्->शर्याणवन्त्
शर्याति->शार्याति
शर्वरीक->शार्वरिक
शर्वरीक->शार्वरीक
शर्वाणी->शार्वरी
शलभ->शालभ
शल्मलि->शल्मली
शल्मलि->शाल्मली
शल्लकि->शल्लकी
शशबिन्दु->शाशबिन्दु
शशाण्डुलि->शशाण्डुली
शशादन->शाशदान
शस्त्रवन्त्->शास्त्रवन्त्
शाकपूणि->शाखापुरी
शाका->शाखा
शाकी->शाखी
शाखि->शाखी
शांकरि->शांकरी
शाट्यायनि->शाट्यायनी
शाट्यायनि->शाठ्यायनि
शाठ्यवन्त्->शाठ्यावन्त्
शाणक->शारक
शाणपाद->शारपद
शाणि->शाणी
शाणि->शारी
शाणिक->शारिक
शाणित->शारित
शानि->शानी
शान्तिकर->शान्तिकार
शापटिक->शापठिक
शापनाशन->शापनासन
शाबरि->शाबरी
शाबस्ति->शाबस्ती
शाम्बर->शाम्भर
शारि->शारी
शार्ङ्गष्टा->शार्ङ्गष्ठा
शालङ्क->शालाङ्क
शालिपिण्ड->शालिपीण्ड
शालिपिष्ट->शालिपिष्ठ
शालुड->शालूढ
शाल्मलि->शाल्मली
शास्त्रचारण->शास्त्राचरण
शिक्षण->शिक्षाण
शिक्षा->शीक्षा
शिख->शीक
शिखि->शिखी
शिङ्गि->शिङ्गी
शिति->शिती
शितिपद्->शितिपाद्
शिपविष्ट->शिपविष्ठ
शिम्बि->शिम्बी
शिम्बि->शिंबी
शिम्बिपर्णी->शिम्बीपर्णी
शिरोदामन्->शिरोधामन्
शिलवाहा->शिलावहा
शिवकर->शिवाकार
शिवरात्रि->शिवरात्री
शिवस्तुति->शिवास्तुति
शिशय->शिशाय
शिशिरय्->शिशिराय्
शिशुक->शिसुक
शीघ्रिय->शीघ्रीय
शीर्षहार्य->शीर्षाहार्य
शुकनशा->शुकनाशा
शुकनशा->शुकनासा
शुकनसा->शुकनाशा
शुकनसा->शुकनासा
शुकपिण्डि->शुकपिण्डी
शुकपिण्डि->शूकपिण्डी
शुचि->शुची
शुचि->शूचि
शुचिश्रवस्->शुचिस्रवस्
शुण्ठि->शुण्ठी
शुद्धोदन->शुद्धौदन
शुन्ध्यु->शुन्ध्यू
शुभ्रि->शुभ्री
शुम्भन->शुम्भान
शुष्मिण->शुष्मीण
शूकपिण्डि->शूकपिण्डी
शूकशिम्बि->शूकशिम्बी
शूलि->शूली
शूलिक->शूलीक
शृङ्गि->शृङ्गी
शेफालि->शेफाली
शेवलिनी->शैवालिनी
शेवलिय->शैवालीय
शेवार->शैवर
शैक्य->शैख्य
शैबल->शैबाल
शैलालि->शैलाली
शैवलिनी->शैवालिनी
शैवि->शैवी
शोठ->शौट
शोण->शौर
शोभक->शोभाक
शौचिवृक्षि->शौचिवृक्षी
शौण्डि->शौण्डी
शौनःशेप->शौनःशेफ
शौनकि->शौनकी
शौवदंष्ट्र->शौवादंष्ट्र
श्च्युत्->श्च्युथ्
श्रथ->श्रात
श्रद्दधान->श्रद्धादान
श्रद्धाप्रकरण->श्राद्धप्रकरण
श्रमणक->श्रामणक
श्रवणक->श्रावणक
श्रवणद्वादशी->श्रावणद्वादशी
श्रवणी->श्रावणी
श्रित->श्रीत
श्रिति->श्रिती
श्रियध्यै->श्रीयध्यै
श्रियावासिन्->श्रीयावासिन्
श्रीकर->श्रीकार
श्रीवह->श्रीवाह
श्रुतकीर्ति->श्रुतकीर्ती
श्रुति->श्रुती
श्रुष्टि->श्रुष्टी
श्रेडी->श्रेढी
श्रेणि->श्रेणी
श्रेण्य->श्रैण्य
श्रोणि->श्रोणी
श्रोणिसूत्र->श्रोणीसूत्र
श्रोत्रिय->श्रोत्रीय
श्लख->श्लाख
श्वपद्->श्वापद्
श्वयीचि->श्वयीची
श्वसन->श्वसान
श्वसनाशन->श्वसनासन
श्वेत->श्वैत
श्वेततर->श्वेततार
श्वेतय्->श्वेताय्
श्वेत्र->श्वैत्र
षट्पद्->षट्पाद्
षडंश->षडंस
षडर->षडार
षड्ग्रन्थि->षड्ग्रन्थी
षण्ड->षाण्ड
षण्डीय्->षण्ढीय्
षण्ढ->षाण्ड
षण्मुख->षाण्मुख
षष्टि->षष्टी
षष्टि->षष्ठी
षष्टिक->षाष्टीक
षष्टिमत्त->षष्ठिमत्त
षष्टिव्रत->षष्ठीव्रत
षष्टिहायन->षष्ठिहायन
षष्टिह्रद->षष्ठीह्रद
षात्वणत्विक->षात्वणात्विक
षाष्टिक->षाष्टीक
षोडशसहस्र->षोडशसाहस्र
ष्ठिव्->ष्ठीव्
संयत->संयात
संयती->संयाती
संयमवन्त्->संयामवन्त्
संयाति->संयाती
संवत्->संवात्
संवसन->संवसान
संवाद->संवाध
संशिति->संशीति
संश्रवण->संश्रावण
संसद्->संसाध्
संसारतरणि->संसारतरणी
संसृष्टि->संसृष्टी
संस्पर्शन->संस्पर्शान
संस्रवण->संस्रावण
संहर्षिन्->संहार्षिन्
सकल->सकाल
सकाकोल->सकाकौल
सकृद्ग्रह->सकृद्ग्राह
सक्ति->सक्थि
सक्ति->सक्थी
संकरिन्->संकारिन्
सङ्ग->सङ्घ
सङ्गट->सङ्घट
सङ्गट->सङ्घाट
सङ्गतल->सङ्घतल
संगीति->संगीती
संघटक->संघाटक
सचन->सचान
सचि->सची
सजल->सजाल
संचल->संचाल
संजवन->संजावन
संजिति->संजीति
संज्ञपन->संज्ञापन
सट->सठ
सत्कृति->सत्कृती
सत्त्रशाला->सत्त्रसाला
सत्त्रि->सत्त्री
सत्त्रिय->सत्त्रीय
सत्यश्रवस्->सत्यस्रवस्
सत्रासह्->सत्रासाह्
सदन्य->सधन्य
सदम->सदाम
सदर->सदार
सदश->सदस
सदश्व->सदाश्व
सधि->सधी
सनता->सनाथा
सनय->सनाय
सनिस्रस->सनीस्रस
संतति->संतती
संदानिका->संधानिका
संदाय->संधय
संदाव->संधाव
संदिह्->संधिः
सन्दी->सन्धि
संधि->संधी
संध्यांश->संध्यांस
सन्नद->सन्नाद
सन्नि->सन्नी
सपर->सफर
सप्ततितम->सप्तातितम
सप्तभङ्गिनय->सप्तभङ्गीनय
सप्ताश्र->सप्तास्र
सभाचर->सभाचार
सभापति->सभापती
सभिक->सभीक
समचतुरश्र->समचतुरस्र
समदु->समाधू
समधृत->समादृत
समनीक->समानीक
समन्त->समान्त
समन्तप्रसादिक->समन्तप्रासादिक
समभाग->समाभाग
समभ्याश->समभ्यास
समयकार->समयाकार
समया->समाया
समर->समाण
समरण->समराण
समरण->समारण
समरण->समाराण
समरत->समारत
समरथ->समारत
समवर्तिन्->समावर्तिन्
समवस्रव->समवस्राव
समवहार->समवाहार
समस्->समास्
समासङ्ग->समासाङ्ग
समिन्धन->समिन्धान
समिष्->समीष्
समीप->सामीप
समीपनयन->समीपनायन
समीरण->सामीरण
समुद्रिय->समुद्रीय
समुन्नस->समुन्नास
समूर->सामूर
समृद्धि->समृद्धी
संपद->सम्पाद
संपद->साम्पद
संपदिन्->सम्पादिन्
संपर->सम्पार
संपराय->साम्पराय
संपवन->सम्पावन
संपाट->सम्पाठ
संपाद->साम्पद
संप्रति->सम्प्रती
संप्रति->संप्रती
संप्रदान->सम्प्रधान
संप्रेष->सम्प्रैष
संफल->सम्फाल
संबन्धि->सम्बन्धी
संबल->सम्भल
संबल->संभाल
संबलन->संभालन
संभर->सम्भार
संभल->संभाल
संभवन->सम्भावन
संभविन्->सम्भाविन्
संभव्य->सम्भाव्य
संभु->सम्भू
संभु->संभू
संभूति->सम्भूती
संमद->सम्माद
सरङ्ग->सराङ्घ
सरण्यु->सरण्यू
सरयु->सरयू
सरल->सराल
सरसिज->सरसीज
सरस्वतिकृत->सरस्वतीकृत
सरि->सरी
सर्पि->सर्पी
सर्वतनु->सर्वतनू
सर्वदेवत्य->सर्वदैवत्य
सर्वधर->सर्वधार
सर्वपुरुष->सर्वपूरुष
सर्वभयंकर->सर्वाभयंकर
सर्वमय->सर्वमाय
सर्वयोनि->सर्वयोनी
सर्वरस->सर्वरास
सर्वसंभव->सर्वासम्भव
सर्वसंभव->सर्वासंभव
सर्वौषधि->सर्वौषधी
सवर->सवाण
सवितृदेवत->सवितृदैवत
सशर->ससार
सशूक->ससूक
सस्यद्->सस्याद्
सहदेवि->सहदेवी
सहपुरुष->सहपूरुष
सहस्य->सहास्य
सहस्रघ्नि->सहस्रघ्नी
सहस्रनिर्णिज्->सहस्रानिर्णिज्
सहस्रपद्->सहस्रपाद्
सहस्रमुष्क->सहस्रमूष्क
सहस्रश्रुति->सहस्रस्रुति
सहूति->सहूती
सांयोगिक->सांयौगिक
साक्षि->साक्षी
सांग्रहिक->सांग्राहिक
साचि->साची
सादन->साधान
सादि->सादी
साधन->साधान
सानसि->सानसी
सामन->सामान
सामन्त->सामान्त
सामुद्रि->सामुद्री
सायण->सायर
सारणि->सारणी
सारस->सारास
सार्वकर्मिक->सार्वकार्मिक
सार्ववर्णिक->सार्ववार्णिक
सार्वसेनि->सार्वसेनी
सार्ष्टि->सार्ष्ठि
सालाकरी->सालाकारी
सावित्रि->सावित्री
सिंहसेन->सिंहसैन
सित->सीत
सितपट->सीतापट
सिति->सिती
सिन्धुरद्वेषिन्->सिन्धुरद्वैषिन्
सिन्धुराज->सिन्धूराज
सिम->सीम
सिरी->सीरि
सिरी->सीरी
सुकर->सूकार
सुकष्ट->सुकाष्ठ
सुकाशन->सुखाशन
सुकाशन->सुखासन
सुकुमल->सुकुमाल
सुकृति->सुकृती
सुकेत->सुखेत
सुकेशि->सुकेशी
सुखकर->सुखकार
सुखकर->सुखाकर
सुखवत्->सुखावत्
सुखस्पर्श->सुखास्पर्श
सुगन्धार->सुगान्धार
सुगन्धि->सुगन्धी
सुगीत->सुगीथ
सुत्->सूत्
सुतनय->सूतनय
सुतनु->सुतनू
सुतप->सुताप
सुतपस्->सूतपस्
सुतसुत->सुतासुत
सुतसुत->सूतसुत
सुतात्मज->सूतात्मज
सुतार्णव->सूतार्णव
सुति->सूती
सुती->सूती
सुदत्त->सूदत्त
सुदन्त->सूदन्त
सुदशन->सुधाशन
सुदान्त->सूदन्त
सुदाम->सुधाम
सुदामन्->सूदामन्
सुदामन->सुधामान
सुदाय->सुधय
सुदिह्->सुधीः
सुदीदिति->सुदीदीति
सुधामन्->सूदामन्
सुधावन्त्->सूदवन्त्
सुधि->सूदि
सुधि->सूदी
सुधित->सूदित
सुधी->सूदि
सुधी->सूदी
सुनु->सुनू
सुनु->सूनू
सुपद्->सुपाद्
सुपद->सुपाद
सुपर्वण->सुपर्वाण
सुपर्वन्->सुपर्वान्
सुपु->सुपू
सुप्रज्ञ->सुप्राज्य
सुप्रतिकर->सुप्रतीकार
सुफालिह->सुफालीह
सुभ्रु->सुभ्रू
सुभ्रुनासाक्षिकेशान्त->सुभ्रूनासाक्षिकेशान्त
सुमति->सुमती
सुमहामनस्->सुमाहामनस्
सुमालि->सुमाली
सुमित्रभू->सुमित्राभू
सुम्नयु->सुम्नायु
सुयवसाद्->सूयवसाद्
सुयवसिन्->सूयवसिन्
सुयवस्यु->सूयवस्यु
सुर्->सूर्
सुरजा->सुराजा
सुरण->सूरण
सुरत->सूरथ
सुरता->सुरथा
सुरता->सूरता
सुरथ->सूरथ
सुरदुन्दुभि->सुरदुन्दुभी
सुरनन्दा->सुरानन्दा
सुरप्रिय->सुराप्रिय
सुरभि->सुरभी
सुरभिष्टम->सुरभिष्ठम
सुरभिसमय->सुरभीसमय
सुरभिस्रवा->सुरभीस्रवा
सुरसाष्ट->सुरसाष्ठ
सुरसिन्धु->सुरासिन्धु
सुरसुत->सूरसुत
सुराचार्य->सूराचार्य
सुराजि->सूरजी
सुरापगा->सूरापगा
सुरि->सुरी
सुरुचि->सुरुची
सुवर्->सुवार्
सुवर्णष्ठीवि->सुवर्णष्ठीवी
सुवल्लि->सुवल्ली
सुविक्रान्तविक्रमिन्->सुविक्रान्तविक्रामिन्
सुशंस->सुसांस
सुशक्ति->सुसक्थि
सुशमि->सुसमी
सुशमी->सुसमी
सुशिख->सुशीक
सुशिप्र->सुसिप्र
सुशेरु->सुसेरु
सुश्रोणि->सुश्रोणी
सुश्रोणि->सुस्रोणि
सुह्->सूः
सुहव->सूहव
सूकर->सूकार
सूक्तवाक->सूक्तावाक
सूचि->सूची
सूचिपत्त्रक->सूचीपत्त्रक
सूति->सूती
सूतिमास->सूतीमास
सूत्रग्रह->सूत्रग्राह
सूनु->सूनू
सून्मद->सून्माद
सूरत->सूरथ
सृजन->सृजान
सृणि->सृणी
सृणिक->सृणीक
सृप->सृफ
से->सै
सेट->सेठ
सेनजित्->सेनाजित्
सैरि->सैरी
सोदय->सौधाय
सोभरि->सोभरी
सोभरि->सौभरी
सोम->सौम
सोमदेवत्य->सोमदैवत्य
सोमपद->सोमपाद
सोमपीति->सोमपीती
सोमवन्त्->सोमावन्त्
सोमापि->सौमापि
सोमाश्रयायण->सोमाश्रायायण
सोमेन्द्र->सोमैन्द्र
सोहञ्जि->सोहाञ्जि
सौत्रामणि->सौत्रामणी
सौधकार->सौधाकर
सौभरि->सौभरी
सौरपत->सौरपात
सौरमस->सौरमास
सौरि->सौरी
सौवर्णबलज->सौवर्णबालज
स्कन्दपुराण->स्कान्दपुराण
स्कन्दोपनिषद्->स्कान्दोपनिषद्
स्तन->स्थन
स्तनभव->स्थानाभाव
स्तनान्तर->स्थानान्तर
स्तम्बघात->स्तम्भगत
स्तम्बवती->स्तम्भवती
स्तम्बिन्->स्तंभिन्
स्तम्बेरम->स्ताम्बेरम
स्तव->स्थव
स्तवन->स्तवान
स्तवान्->स्थावन्
स्ताव->स्थव
स्तुति->स्तुती
स्तुतिशस्त्र->स्तुतिशास्त्र
स्तूणाकर्ण->स्थुणाकर्ण
स्तेम->स्थेम
स्तेय->स्थैय
स्तोत्रिय->स्तोत्रीय
स्तौल->स्थौल
स्त्रीवश->स्त्रीवास
स्थग->स्थाघ
स्थपनी->स्थापनी
स्थाग->स्थाघ
स्थानपत->स्थानपात
स्थापत्य->स्थापथ्य
स्थायि->स्थायी
स्थिति->स्थिती
स्थिरीकर->स्थिरीकार
स्थुरिका->स्थूणिका
स्थूरि->स्थूरी
स्थूलकाष्ठदह्->स्थूलकाष्ठधह्
स्थूलशाटि->स्थूलशाटी
स्थूलशूरण->स्थूलसूरण
स्थेय->स्थैय
स्नीहिति->स्नीहिती
स्नेहिति->स्नेहिती
स्पर्शन->स्पर्शान
स्पश->स्पाश
स्पृशि->स्पृशी
स्फटिकारि->स्फटिकारी
स्फल्->स्फाल्
स्फाणि->स्फारी
स्फीति->स्फीती
स्फुटि->स्फुटी
स्मरारि->स्मारणी
स्यद्->स्याद्
स्यन्दनि->स्यन्दनी
स्यूमरश्मि->स्यूमरश्मी
स्रुत->स्रूत
स्वगति->स्वागती
स्वगा->स्वघा
स्वद्->स्वाद्
स्वदन->स्वदान
स्वदन->स्वधन
स्वदन->स्वादान
स्वदयितर्->स्वादयितर्
स्वधित->स्वादित
स्वधिति->स्वधिती
स्वधिति->स्वधीति
स्वधीत->स्वादित
स्वधेनव->स्वधैनव
स्वपति->स्वपती
स्वयंभु->स्वयम्भू
स्वयंभु->स्वायम्भू
स्वयंभुव->स्वायम्भुव
स्वयंभू->स्वायम्भू
स्वर्गत->स्वर्गात
स्वर्णकूट->स्वर्णकूठ
स्वर्णशेफालिका->स्वर्णसेफालिका
स्वल्प->स्वाल्प
स्ववशिनी->स्ववासिनी
स्ववशिनी->स्वावासिनी
स्वसर्->स्वसार्
स्वसर->स्वसार
स्वस्ति->स्वस्थी
स्वस्ती->स्वस्थी
स्वाति->स्वाती
स्वादन->स्वादान
स्वादुकर->स्वादुकार
स्वाद्य->स्वाध्य
स्वाहाकृति->स्वाहाकृती
स्वोरस->स्वौरस
हंसपदी->हंसपादी
हंसपरमेश्वर->हंसपारमेश्वर
हंसाङ्घ्रि->हंसाङ्घ्री
हटपर्णि->हटपर्णी
हनु->हनू
हनुमन्->हनुमान्
हनुमन्->हनूमान्
हन्तकार->हन्ताकार
हयगर्दभि->हयगर्धभि
हरि->हरी
हरि->हारी
हरिणक->हारिणक
हरितत्त्वमुक्तावलि->हरितत्त्वमुक्तावली
हरिदश्व->हारिदश्व
हरिद्रामेह->हारिद्रमेह
हरिद्रामेहिन्->हारिद्रमेहिन्
हरिमन्->हरीमन्
हरिश्रावा->हरिस्रावा
हर्यत->हर्यात
हलभृत्->हालभृत्
हलहला->हालाहला
हला->हाला
हलि->हली
हलि->हाली
हल्लीश->हल्लीस
हव्यवह्->हव्यवाह्
हव्यसूद्->हव्यासूद्
हसिका->हासिका
हस्तमुक्तावलि->हस्तमुक्तावली
हस्तयत->हस्तायत
हस्ताङ्गुलि->हस्ताङ्गुली
हस्तिनापुर->हास्तिनापुर
हहल->हहाल
हहल->हाहल
हहल->हाहाल
हहव->हाहव
हाडि->हाडी
हारव->हाराव
हारि->हारी
हारीति->हारीती
हास्तिनपुर->हास्तिनापुर
हिङ्गुलि->हिङ्गुली
हिङ्गुशिराटिका->हिङ्गुसिराटिका
हित->हीत
हिमपात->हिमापात
हिरण्यय->हिरण्याय
हिरण्यशृङ्ग->हिरण्यसृङ्ग
हिल->हीLअ
हिलमोचि->हिलमोची
हुगलि->हुगली
हुड->हूड
हुतवह->हुतवाह
हुतहव्यवह->हुतहव्यवाह
हुन्->हून्
हुरस्->हूणस्
हुहु->हुहू
हुहु->हूहु
हेड->हेढ
हेतु->हेतू
हेरम्ब->हेराम्ब
हेरम्भ->हेराम्ब
होमि->होमी
होमीय->हौमीय
ह्मल->ह्माल
ह्रणिया->ह्रणीया
ह्रस्->ह्रास्
ह्रादुनि->ह्रादुनी
ह्रित->ह्रीत
ह्रुडु->ह्रुडू
ह्रोड->ह्रौड
अणूभू->अणुभू
अधिष्ठातर्->अधिष्टातर्
अनड्वाह्->अनड्वह्
अनालम्भुक->अनालम्बुक
अपची->अपचि
अपाची->अपचि
अपाञ्च्->अपञ्च्
अपत्यसाच्->अपत्यसच्
अपात्र->अपत्र
अपाप->अपप
अपराह्ण->अपराःण
अपराभाव->अपराभव
अपरूप->अपरुप
अपालम्ब->अपलम्ब
अपवाद->अपवद
अपवारण->अपवरण
अपावृत्->अपवृत्
अपावृत->अपवृत
अपावृत्त->अपवृत्त
अपश्री->अपश्रि
अपष्ठ->अपष्ट
अपाष्ठ->अपष्ट
अपष्ठु->अपष्टु
अपस्तम्भ->अपस्तम्ब
अपाश्या->अपस्या
अपहार->अपहर
अफल->अपाल
अपीच्य->अपिच्य
अपीजू->अपिजू
अपीजू->अपीजु
अपूरण->अपुराण
अपूरुष->अपुरुष
अपेक्षाबुद्धि->अपेक्षबुद्धि
अपोद्धार्य->अपोद्धर्य
अप्राण->अप्रण
अप्रतीकार->अप्रतिकार
अप्रतिष्ठ->अप्रतिष्ट
अप्रधान->अप्रदान
अप्रमाद->अप्रमद
अप्सुवाह्->अप्सुवह्
अबाध->अबध
अभि->अबि
अभी->अबि
अभिध्या->अबिद्या
अभीत->अबीत
अभीर->अबीर
अब्धि->अब्दि
अब्राह्मण->अब्रह्मण
अभिघात->अभिगत
अभितराम्->अभितरम्
अभिधा->अभिदा
अभिमातिषाह्->अभिमातिषह्
अभीरु->अभिरु
अभीवर्त->अभिवर्त
अभिवाह->अभिवह
अभीवृत्->अभिवृत्
अभीवृत->अभिवृत
अभिशान्त्व->अभिशन्त्व
अभिसान्त्व->अभिशन्त्व
अभिश्री->अभिश्रि
अभिषाच्->अभिषच्
अभिषाह्->अभिषह्
अभीषाह्->अभिषह्
अभीषाह->अभिषह
अभीषाह->अभिषाह
अभीषु->अभिषु
अभीषु->अभिषू
अभिसंपात->अभिसंपत
अभिसारी->अभिसरी
अभीशु->अभिसू
अभिहार->अभिहर
अभीषाह्->अभीषह्
अभ्याचार->अभ्याचर
अभ्यूह->अभ्युह
अभ्यूह्य->अभ्युह्य
अमांस->अमंस
अमी->अमि
अमृताकर->अमृतकर
अमृताक्षर->अमृतक्षार
अमृतासु->अमृताशु
अम्भ्->अंब्
अम्लसार->अम्लशार
अयाचित->अयचित
अयज्ञसाच्->अयज्ञसच्
अयथ->अयत
अयाथातथ्य->अयथातथ्य
अयस्->अयश्
अयास्->अयश्
अरण्यकार्पासी->अरण्यकर्पासी
अरण्यायन->अरण्ययान
अरण्यवास्तूक->अरण्यवास्तुक
अरण्यौकस्->अरण्योकस्
अरथ->अरत
अरथी->अरथि
अराति->अरथि
अराय->अरय
अरालु->अरलु
अरिष्टसूदन->अरिष्टसुदन
अर्घ्य->अर्ग्य
अर्थीय->अर्थिय
अर्थौघ->अर्थौग
अर्ध->अर्द
अर्धिन्->अर्दिन्
अर्धद्रौणिक->अर्धद्रोणिक
अर्धपाद->अर्धपद
अर्धहार->अर्धहर
अर्धासन->अर्धाशन
अर्पणमीमांसा->अर्पणमिमांसा
अर्पिस->अर्पिश
अर्भ->अर्ब
अलजी->अलजि
अलास्य->अलस्य
अवगथ->अवगत
अवघात->अवगत
अवगाद->अवगध
अवगुण्ठन->अवगुण्टन
अवघूर्ण->अवगूर्ण
अवाग्र->अवघ्र
अवर->अवण
अवार->अवण
अवतार->अवतर
अवधातव्य->अवदातव्य
अवधारित->अवदारित
अवपान->अवपन
अवभृथ->अवभृत
अवमान्य->अवमन्य
अवयाज्->अवयज्
अवारण->अवरण
अवारपार->अवरपर
अवार्य->अवर्य
अवसक्थिका->अवशक्थिका
अवसित->अवशीत
अवसक्थिका->अवसक्तिका
अवसान->अवसन
अवाचीन->अवाचिन
अवान्तराम्->अवान्तरम्
अवीत->अवित
अविभू->अविभु
अविष्ठ->अविष्ट
अव्यथि->अव्यती
अशनाया->अशनया
अश्मपृष्ठ->अश्मपृष्ट
अश्रीक->अश्रिक
अश्लीक->अश्लिक
अश्वपाद->अश्वपद
अश्वसूक्ति->अश्वसुक्ति
अश्वस्थान->अश्वस्तन
अष्टानवति->अष्टनवति
अष्टपाद्->अष्टपद्
अष्टासप्तति->अष्टसप्तति
अष्ठि->अष्टी
असंस्थित->असंस्तीत
असक्थ->असक्त
असंभाव्य->असम्भव्य
असंभाव्य->असंभव्य
असाधन->असादन
असिक्नी->असिक्नि
असूसु->असुसू
असृग्धरा->असृग्दरा
असृग्धारा->असृग्दरा
अस्ताग->अस्तग
अस्ताघ->अस्तग
अस्थाग->अस्तग
अस्तमीके->अस्तमिके
अस्थि->अस्ती
अस्थिक->अस्तीक
अस्वास्थ्य->अस्वस्थ्य
अहंमान->अहंमन
अहस्->अहश्
अहीन->अहिन
अहैतुक->अहेतुक
अह्नी->अह्नि
आख->आक
आखात->आकथ
आखा->आका
आखु->आकु
आकूत->आकुत
आखु->आकू
आक्षार->आक्षाण
आघात->आगथ
आगामिक->आगमिक
आगमिष्ठ->आगमिष्ट
आग्नीध्र->आग्निध्र
आघ्रेय->आग्रेय
आचाम->आचम
आचाम्य->आचम्य
आजकरौण->आजकरोण
आजान->आजन
आजीगर्त->आजिगर्त
आञ्छ्->आञ्च्
आञ्छन->आञ्चन
आटीकर->आटिकर
आढक->आडक
आडारक->आडाणक
आर->आण
आरुक->आणुक
आरुक->आणूक
आतान->आतन
आतिच्छन्दस->आतिच्छन्दश
आतिरैक्य->आतिरेक्य
आतिशायिक->आतिशयिक
आत्मबोध->आत्मबोद
आत्माराम->आत्मराम
आदारिन्->आदरिन्
आधर्य->आदर्य
आधार्य->आदर्य
आदिताल->आदितल
आदिसूर->आदिशूर
आधि->आदी
आधी->आदी
आध्या->आद्या
आधान->आधन
आनाथ्य->आनत्य
आनामन->आनमन
आनस->आनश
आन्वीक्षिकी->आन्वीक्षिकि
आपालि->आपलि
आपस्->आपश्
आपीत->आपित
आप्री->आप्रि
आबाल्यम्->आबल्यम्
आभील->आबिल
आभील->आभिल
आभ्यासिक->आभ्याशिक
आमात्य->आमत्य
आमात्य->आमथ्य
आयःशूलिक->आयःशुलिक
आयास्य->आयस्य
आरातीय->आरतीय
आरी->आरि
आरुह्->आरुः
आरोध->आरोद
आर्चाभिन्->आर्चभिन्
आर्जीक->आर्जिक
आर्त्नी->आर्त्नि
आलान->आलन
आलापिन्->आलपिन्
आलम्भ->आलंब
आलम्भिन्->आलंबिन्
आलम्भुक->आलम्बुक
आलम्भ्य->आलम्ब्य
आवार->आवण
आवार->आवर
आवारि->आवरि
आवास्य->आवश्य
आविस्->आविश्
आवेध->आवेद
आस्->आश्
आसक्त->आशक्त
आसक्ति->आशक्ति
आशास्य->आशस्य
आसिका->आशिका
आशिष्ठ->आशिष्ट
आसीन->आशीन
आसुति->आशुति
आसुर->आशूर
आस्माक->आश्मक
आस्य->आश्य
आस्या->आश्या
आसात्->आसत्
आस्तारक->आस्तरक
आहू->आहु
आहूति->आहुती
इलास्पद->इLअस्पद
इला->इLआ
ईह्->इः
इख्->इक्
इक्षुसार->इक्षुशर
ईङ्ख्->इङ्क्
ईङ्ख्->इङ्ख्
इर्->इण्
ईर्->इण्
ईद्ध्रात्->इद्ध्रात्
इन्दूर->इन्दुर
इन्द्रवाह्->इन्द्रवह्
इभावन्त्->इभवन्त्
ईम्->इम्
ईर->इर
ईषाधार->इषाधार
ईह्->ईः
ईषाधार->ईषधर
ईषाधार->ईषाधर
उकार->उकण
उक्थवन्त्->उक्तवन्त्
उच्चारण->उच्चरण
उच्चारित->उच्चरित
उच्छून->उच्छुन
उच्छ्लख->उच्छ्लक
उड्डामर->उड्डमर
उत्कण्ठक->उत्कण्टक
उत्खला->उत्कला
उत्खरिन्->उत्कारिन्
उत्कास->उत्काश
उत्थापनीय->उत्तपनीय
उत्तराङ्ग->उत्तरङ्ग
उत्तरात्->उत्तरत्
उत्तराहि->उत्तरहि
उत्तार्य->उत्तर्य
उत्थापन->उत्तापन
उत्पलावन->उत्पलवन
उत्पाली->उत्पली
उत्प्रासन->उत्प्राशन
उत्सक्थ->उत्सक्त
उत्साद->उत्सद
उत्सादन->उत्सदन
उत्सेध->उत्सेद
उधन्->उदङ्
उदारक->उदरक
उदरावेष्ट->उदरवेष्ट
उधस्->उदश्
उधस्->उदस्
उदास्त->उदस्त
उधस्->उदास्
उदाहार->उदाहर
उदीची->उदिची
उदीची->उदीचि
उदूह->उदुह
उद्घ->उद्ग
उद्गाथा->उद्गता
उद्गाथा->उद्गाता
उद्घन->उद्गान
उद्गीथ->उद्गीत
उद्ग्राह->उद्ग्रह
उद्घाटक->उद्घटक
उद्घाटित->उद्घटित
उद्धान्त->उद्दान्त
उद्धय->उद्दाय
उद्ध्य->उद्द्य
उद्धान->उद्धन
उद्भूति->उद्भुति
उद्वाचन->उद्वचन
उपकार->उपकर
उपकूल->उपकुल
उपाक्ष->उपक्ष
उपाख्या->उपख्या
उपगूढ->उपगुड
उपाग्र->उपग्र
उपढौकन->उपढोकन
उपतापन->उपतपन
उपधिक->उपदीक
उपादिक->उपदीक
उपाधिक->उपदीक
उपधान->उपधन
उपादान->उपधन
उपाधि->उपधी
उपाध्याय->उपध्याय
उपानह्->उपनह्
उपमात्->उपमथ्
उपयान->उपयन
उपायन->उपयन
उपायात->उपयात
उपारुह्->उपरुह्
उपलम्भ->उपलम्ब
उपालम्भ->उपलम्ब
उपालि->उपली
उपावसित->उपवासित
उपावी->उपवी
उपावृत्->उपवृत्
उपावृत्त->उपवृत्त
उपशान्ति->उपशन्ति
उपसि->उपशी
उपाश्रय->उपश्रय
उपश्री->उपश्रि
उपासङ्ग->उपसङ्ग
उपासङ्ग->उपसङ्घ
उपासादित->उपसादित
उपासन->उपसान
उपस्तार->उपस्तर
उपास्ति->उपस्थि
उपावी->उपावि
उपोती->उपोति
उभयतस्->उभयतश्
उभयादन्त्->उभयदन्त्
उम्भि->उंबी
उरस्->उरश्
ऊररी->उरारि
उरूक->उरुक
उरूल->उरुल
उरुवूक->उरुवुक
उरोघात->उरोगत
ऊर्ज्->उर्ज्
ऊर्जस्कर->उर्जस्कर
ऊर्ण->उर्ण
ऊर्द->उर्द
ऊर्ध->उर्द
ऊर्मिला->उर्मिला
उलपराजी->उलपराजि
उलूक->उलुक
ऊलूक->उलुक
उलूपी->उलुपी
उल्लास->उल्लस
उल्लासन->उल्लसन
उल्लू->उल्लु
ऊषण->उषर
ऊषर->उषर
उष्णांशु->उष्णंशु
उष्णासह->उष्णसह
उष्णीगङ्ग->उष्णिगङ्ग
उष्णीनाभ->उष्णिनाभ
उष्णीष->उष्णिष
ऊष्मा->उष्मा
ऊह->उह
ऊह्य->उह्य
ऊह्->ऊः
ऊखर->ऊकार
ऊरुग्राह->ऊरुग्रह
ऊर्जवाह->ऊर्जवह
ऊर्णामय->ऊर्णमय
ऊर्ध्वथा->ऊर्ध्वता
ऊर्वष्ठीव->ऊर्वष्टीव
ऊहनीय->ऊहनिय
ॠकार->ऋकार
ऋज्राश्व->ऋज्रश्व
ऋतनी->ऋतनि
ऋतसाप्->ऋतसप्
ऋभुक्षीन्->ऋभुक्षिन्
ऐकपदिक->एकपदिक
एकाराम->एकरम
ऐकाग्निक->एकाग्निक
ऐकान्तिक->एकान्तिक
ऐकान्त्य->एकान्त्य
एकान्नादिन्->एकान्नदिन्
एकाष्ठील->एकाष्टील
ऐणिक->एणीक
एध्->एद्
ऐध्->एद्
एमूष->एमुष
ऐण->एर
ऐर->एर
एलापत्र->एलपत्र
ऐलवालुक->एलवालुक
एलावली->एलावलि
ऐलवालुक->एलावालुक
ऐषावीर->एषावीर
ऐषीक->एषिक
ऐडूक->ऐडुक
ऐभी->ऐभि
ऐलाक->ऐलक
ऐषीक->ऐषिक
औक्थ->ओक्त
औदक->ओदक
औदनिक->ओदनिक
औदन्य->ओदन्य
ओवीली->ओविली
औवीली->ओविली
औषधि->ओषधी
औष्ट्र->ओष्ट्र
औपाधिक->औपधिक
औपरौधिक->औपरोधिक
औषधावली->औषधावलि
कंस्->कंश्
ककुभ्->ककुब्
काक्षि->कक्षी
काक्षी->कक्षी
काक->कख
काग->कग
कङ्कुष्ठ->कङ्कुष्ट
काङ्गुक->कङ्गुक
काचक->कचक
काचर->कचार
काच्छक->कच्छक
कच्छूमती->कच्छुमती
काञ्चनक->कञ्चनक
काञ्चनप्रभ->कञ्चनप्रभ
काञ्चि->कञ्ची
काञ्ची->कञ्ची
कञ्चूल->कञ्चुल
कटाक्ष->कटक्ष
कटप्रू->कटप्रु
कठमर्द->कटमर्द
कटार->कटर
कठर->कटर
कठिनता->कटिनता
कठिल्ल->कटिल्ल
कटिशृङ्खला->कटिशृङ्कला
कट्टार->कट्टण
काट्य->कट्य
काठक->कठक
काठशाठिन्->कठशाठिन्
कडार->कडर
करक->कणक
कारक->कणक
करज->कणज
कारज->कणज
करबक->कणभक
करभक->कणभक
कारव->कणव
करशीकर->कणशीकर
कारा->कणा
कणीका->कणिका
करिका->कणिका
कारिका->कणिका
करिन्->कणिन्
कारिन्->कणिन्
करिष्ठ->कणिष्ठ
करि->कणी
कारि->कणी
कर्करि->कण्काणि
कण्टकश्रेणी->कण्टकश्रेणि
कण्टकाढ्य->कण्टकाड्य
कण्टकी->कण्टकि
कण्टकीद्रुम->कण्टकिद्रुम
कण्ठगत->कण्टगत
काण्ड->कण्ड
काण्डनी->कण्डनी
काण्डार->कण्डार
कण्डूय्->कण्डुय्
कण्डूरा->कण्डुरा
कण्डूल->कण्डुल
काण्वायन->कण्वायन
काण्वीय->कण्वीय
कात्->कत्
कात्->कथ्
काति->कथी
कादाचित्क->कदाचित्क
कनकाह्वय->कनकाःवय
कनी->कनि
कनिष्ठ->कनिष्ट
कनिष्ठक->कनिष्टक
कानिष्ठिनेय->कनिष्ठिनेय
कान्ति->कन्ति
कान्ती->कन्ति
कंध->कंद
कन्दगुडूची->कन्दगुडुची
कन्दालु->कन्दलु
कान्द->कन्ध
कन्याकुमारी->कन्यकुमारी
कन्याधन->कन्यादान
कापालिक->कपालिक
कापालि->कपाली
कपीकच्छु->कपिकच्छू
कापिञ्जलि->कपिञ्जली
कपीत->कपित
कापित्थक->कपित्थक
कपिलावट->कपिलवट
कपिलाषष्ठी->कपिलषष्ठी
कपिलाह्रद->कपिलह्रद
कापिशायन->कपिशायन
कापिष्ठल->कपिष्ठाल
कफिन->कपीन
कापोति->कपोती
कापा->कफा
कापिल->कफिल
कापी->कफी
काम->कम
कामकामिन्->कमकामिन्
कमठ->कमट
कामठ->कमट
कामलिन्->कमलिन्
कामलि->कमली
कामालिका->कमलीका
कामि->कमि
कामिता->कमिता
काम्पिल्य->कम्पिल्य
काम्पिल्यक->कम्पिल्यक
कम्फिल्ल->कंपिल्ल
काम्पिल्ल->कंपिल्ल
कम्फिल्ल->कम्पिल्ल
काम्पिल्ल->कम्पिल्ल
काम्पिल्लक->कम्पिल्लक
काम्पिल->कम्पील
काम्पील->कम्पील
कम्बू->कंबु
कम्भु->कंबु
काम्बुका->कम्बुका
कम्भु->कंबू
काम्बोजि->कम्बोजी
कम्भारी->कम्भारि
कारणता->करणता
कारणत्व->करणत्व
कारणिक->करणिक
करापात->करपात
कारापथ->करपात
करम्भ->करंब
कारम्भा->करम्भा
कराल->करल
कारव->करव
कारवतीर->करवतीर
कारवल्ली->करवल्ली
करशाखा->करशाका
करशूक->करशुक
करिकणावल्ली->करिकणवल्ली
कारि->करी
कारु->करू
काणेर->करेर
कारोती->करोति
कर्करीका->कर्करिका
कर्कारु->कर्करु
कार्कण->कर्कार
कर्णकण्डू->कर्णकण्डु
कार्णच्छिद्रक->कर्णच्छिद्रक
कर्णपूर->कर्णपुर
कर्णीसुत->कर्णिसुत
कार्दमि->कर्दमी
कर्बूरित->कर्बुरित
कर्मठ->कर्मट
कर्मारक->कर्मरक
कार्मारक->कर्मरक
कर्मस->कर्मश
कलह्->कलः
कलाङ्कुर->कलङ्कुर
कलचूरि->कलचुरि
कलाद->कलद
कलधूत->कलधुत
कलन्धु->कलन्दु
कलाम्बिका->कलंबिका
कलम्बू->कलम्बु
कलाय->कलय
कल्कालय->कल्कलाय
कल्पवल्ली->कल्पवल्लि
कवाट->कवट
कवयी->कवयि
कवारि->कवरी
कविलासिका->कविलाशिका
कव्यवाह्->कव्यवह्
कशीका->कशिका
कसेरु->कशेरू
कषीका->कषिका
काकखर->काककण
काकारि->काकणी
काकार->काकर
काकिनी->काकिनि
काकुदीक->काकुदिक
काकोली->काकोलि
काञ्चीपद->काञ्चिपद
कारम्->काणम्
कारि->काणि
काण्व->काण्Vअ
काण्डपृष्ठ->काण्डपृष्ट
कात्यायनिका->कात्ययनिका
कान्तीनगरी->कान्तिनगरी
कान्थिक->कान्तीक
कामरूपिन्->कामरुपिन्
कामालिका->कामलिका
कामशास्त्र->कामशस्त्र
कामाशोक->कामशोक
कामावसायिता->कामावशायिता
काम्पीलक->काम्पिलक
कारणकारण->कारणकरण
कारणशरीर->कारणशरिर
कारापथ->कारपथ
काराधुनी->काराधुनि
कार्मारक->कार्मणक
कार्यकारण->कार्यकरण
कार्यार्थिन्->कार्यर्थिन्
कार्शानव->कार्शनव
कार्षापण->कार्षपण
कालकाक्ष->कालकक्ष
कालाकाङ्क्षिन्->कालकाङ्क्षिन्
कालपृष्ठ->कालपृष्ट
काललौह->काललोह
कालहार->कालहर
कालोदायिन्->कालोदयिन्
काल्याणिनेय->काल्यणिनेय
कासिका->काशिका
कासीराम->काशीराम
काशू->काशु
कासू->काशु
काष्ठकुद्दाल->काष्टकुद्दाल
काष्ठधात्रीफल->काष्ठधत्रीफल
कीकट->किकट
किखि->किकी
कीकि->किकी
कीकर->किखर
किंकर->किंकण
किङ्किणी->किङ्किणि
कीचक->किचक
कीट->किट
कीटक->किटक
किरि->किणी
कीरि->किणी
किरीट->किरिट
किसर->किशर
कीश->किस
कीकस->कीकश
कीर्तिभाज्->कीर्तिभज्
कुह्->कुः
कुकुर->कुकुण
कुकुन्ध->कुकुन्द
कुकूल->कुकुल
कूची->कुचि
कुठारिक->कुटारिक
कुटीमह->कुटिमह
कुट्टापरान्त->कुट्टापरन्त
कूट्->कुठ्
कुण्ठ->कुण्ट
कुध्र->कुद्र
कूदर->कुधर
कुधी->कुधि
कूदी->कुधि
कूपाङ्क->कुपङ्क
कुपथ->कुपत
कूपक->कुपाक
कूबर->कुबर
कूमनस्->कुमनस्
कुम्भीनस->कुम्भिनस
कूर->कुर
कूर्द->कुर्द
कूर्दन->कुर्दन
कूर्पासक->कुर्पासक
कुलघ्न->कुलग्न
कुलाट->कुलट
कुलाह->कुलह
कूलचर->कुलाचार
कूलिक->कुलीक
कुवीणा->कुविणा
कुवेणी->कुवेणि
कुशावती->कुशवति
कुशावती->कुशवती
कुशाध्य->कुशाद्य
कुसल->कुशाल
कुसिम्बी->कुशिम्बी
कुष्ठ->कुष्ट
कुसीदायी->कुसिदायी
कुसू->कुसु
कुसुमायुध->कुसुमयुध
कुसुमसार->कुसुमसर
कुसुम्भ->कुसुम्ब
कूश्म->कुस्म
कूहना->कुहना
कुहूरव->कुहुरव
कूटपूरी->कूटपूरि
कूटशाल्मलि->कूटशल्मलि
कूर->कूण
कूपाय्->कूपय्
कूर्पास->कूर्पस
कृताग्नि->कृतघ्नी
कृताय->कृतय
कृतसापत्निका->कृतसपत्निका
कृतावसक्थिक->कृतावशक्थिक
कृतिरात->कृतिरथ
कृमीश->कृमिश
कृष्णागुरु->कृष्णगुरु
कृष्णदास->कृष्णदश
कृष्णरूप्य->कृष्णरुप्य
कृष्णावास->कृष्णवास
कृष्णाष्टमी->कृष्णाष्टमि
कैकय->केकाय
कैतव->केतव
केयूर->केयुर
कैरव->केरव
कैलास->केलास
केसराचल->केशराचल
केसराम्ल->केशराम्ल
केसराल->केशराल
केशारि->केशरि
केसरि->केशरि
केसरिका->केशरिका
केसरिन्->केशरिन्
केशारि->केशरी
केसरि->केशरी
कैलास->कैलाश
कोटिकास्य->कोटिकाश्य
कौम्भ->कोम्ब
खोल्->कोल्
कोलनासिका->कोलनाशिका
कोलशिम्बी->कोलशिम्बि
कौलिक->कोलिक
कौलीक->कोलिक
कौलि->कोली
खोलि->कोली
कौवेर->कोवेर
कौशलिका->कोशलिका
कौशिक->कोशिक
कौशीधान्य->कोशीधान्य
कौश->कोस
कौसलक->कोसलक
कौसिद->कोसिद
कौसीद->कोसिद
कौचापाक->कौचपक
कौटीर्या->कौटिर्या
कौदालीक->कौदालिक
कौनखीय->कौनकीय
कौमोदकी->कौमोदकि
खोर->कौर
कौरुपथि->कौरुपति
कौलीनि->कौलिनी
खोलि->कौली
कौसलेय->कौशलेय
कौसल्यायनि->कौशल्यायनि
कौशीतकी->कौशितकी
कौषारव->कौषरव
कौषीतक->कौषितक
क्नू->क्नु
क्नूय्->क्नूञ्
क्रकचपाद्->क्रकचपद्
क्रतूय्->क्रतुय्
क्रमागत->क्रमगत
क्रायक->क्रयक
क्रियाकार->क्रियाकर
क्रियापाद->क्रियापद
क्रौञ्च->क्रोञ्च
क्रौञ्चपदा->क्रोञ्चपदा
क्रौडि->क्रोडी
क्रौष्टुकि->क्रोष्टुकी
क्लिध->क्लिद
क्लीब->क्लिब
क्षारिका->क्षणिका
क्षात्त्र->क्षत्त्र
क्षात्रि->क्षत्रि
क्षात्रि->क्षत्री
क्षपणी->क्षपणि
क्षामि->क्षमी
क्षयद्वीर->क्षयद्विर
क्षायिक->क्षयिक
क्षीण->क्षिण
क्षीर->क्षिण
क्षीण->क्षिर
क्षीर->क्षिर
क्षीव->क्षिव
क्षीरपाण->क्षीणपण
क्षीरशर->क्षीणसार
क्षीरसार->क्षीणसार
क्षीरधि->क्षीणाधि
क्षीरतैल->क्षीरतेल
क्षीरपाक->क्षीरपक
क्षुरक->क्षुणक
क्षोणी->क्षोणि
क्षौणी->क्षोणि
क्षोणीपति->क्षोणिपति
क्षौणीभुज्->क्षोणीभुज्
क्षौर->क्षोर
क्षौणी->क्षौणि
खक्ख्->खक्क्
खगाधिप->खगधिप
खङ्खर->खङ्खण
खञ्जार->खञ्जर
खाञ्जार->खञ्जर
खाटिका->खटिका
खडतू->खडतु
खडी->खडि
खाडी->खडि
खडू->खडु
खड्गारीट->खड्गारिट
खर->खण
खार->खण
खाण्डिक->खण्डीक
खादन->खदन
खानिक->खनिक
खानि->खनी
खरकुटी->खरकुटि
खारि->खरी
खारी->खरी
खारिका->खरीका
खर्जूघ्न->खर्जुघ्न
खार्जुरकर्ण->खर्जूरकर्ण
खर्बूज->खर्बुज
खसीक->खशिक
खशीर->खशिर
खासीर->खशिर
खालीय->खालिय
खासीर->खाशीर
खिङ्खिर->खिङ्किर
खुड्डाक->खुड्डक
खुरासान->खुराशान
गह्->गः
गागनायस->गगनायस
गाङ्गेष्ठी->गङ्गेष्टि
गजपिप्पली->गजपिप्पलि
गड्डारिका->गड्डरिका
गर्->गण्
गरागरी->गणगारि
गणनायक->गणनयक
गणपाठ->गणपाट
गणश्री->गणश्रि
गण्डाली->गण्डली
गर्व->गण्व
गतश्री->गतश्रि
गतीक->गतिक
गन्धनाकुली->गन्धनाकुलि
गन्धमादन->गन्धमदन
गन्धमांसी->गन्धमांसि
गयाशीर्ष->गयशीर्ष
गरिष्ठ->गरिष्ट
गर्ध->गर्द
गर्धन->गर्दन
गर्भ->गर्ब
गर्मूच्छद->गर्मुच्छद
गर्वाय्->गर्वय्
गविष्ठ->गविष्ट
घण्ड->गाण्ड
गाण्डी->गाण्डि
घाति->गाथि
घाति->गाथी
घर्म्य->गार्म्य
गार्हस्थ्य->गार्हस्त्य
घस्->गास्
गिरीयक->गिरियाक
गीथा->गीता
गुच्छाल->गुच्छल
घुट्->गुठ्
घुट->गुठ
गुर्->गुण्
गूर्->गुण्
घुण्->गुण्
घुर्->गुण्
घूर्->गुण्
गुणग्राहिन्->गुणग्रहिन्
गुणशील->गुणशिल
गुणी->गुणि
घुणि->गुणि
घुण्ट->गुण्ठ
गुण्डारोचनिका->गुण्डरोचनिका
घुम्->गुम्
घुण->गुर
घुणि->गुरी
गुरुदैवत->गुरुदेवत
घुलञ्च->गुलञ्च
गूला->गुला
गूह्->गूः
घूक->गूक
गूढपाद्->गूढपद्
गूढपाद->गूढपद
घुण->गूर
घुणि->गूरी
घूर्णिका->गूर्णिका
घृत्सतमस्->गृत्सतमस्
गृध्रकूट->गृध्रकुट
गृभीत->गृभित
गोलिका->गोLइका
गोचारक->गोचरक
घोणा->गोणा
गोरिका->गोणिका
गौरीपति->गोणीपति
गौरीपुत्र->गोणीपुत्र
गौतमि->गोतमी
गोदावरी->गोदावरि
गौधार->गोधार
गोनस->गोनश
गोनास->गोनश
घोनस->गोनश
गौपिक->गोपिक
गोपीत->गोपित
गोपीथ->गोपित
गौपिक->गोपीक
गोपोतालिका->गोपोतलिका
गोमथ->गोमत
गौमत->गोमत
गौराश्व->गोराश्व
गौरास्य->गोरास्य
गोर्ध->गोर्द
गौला->गोला
गोवीथी->गोवीथि
गोसशश->गोशशस
गोसिल->गोशिल
गौषूक्त->गोषूक्त
गोष्ठ->गोष्ट
गोहरीतकी->गोहरितकी
गौरचन्द्र->गौणचान्द्र
गौरि->गौणी
गौधेय->गौदेय
घोरक->गौरक
गौरखर->गौरकर
घोरता->गौरता
घोरवाशन->गौरवासन
घोणा->गौरा
गौरीवित->गौरिवीत
घ्राति->ग्रथि
ग्रन्थकूटी->ग्रन्थकुटी
ग्रामकुक्कुट->ग्रमकुक्कुट
ग्रामघात->ग्रमघात
ग्रामयाजिन्->ग्रमयाजिन्
ग्राम्य->ग्रम्य
ग्रास->ग्रस
ग्रहणीरोग->ग्रहणिरोग
ग्रहाधार->ग्रहधार
ग्राहवन्त्->ग्रहवन्त्
ग्राहिक->ग्रहिक
ग्रामघात->ग्रामगत
ग्रामणी->ग्रामणि
ग्रामपात्र->ग्रामपत्र
घटीका->घटिका
घटीकार->घटीकर
घार->घण
घण्टाकर्ण->घण्टकर्ण
घण्टाली->घण्टालि
घाण्टिक->घण्टिक
घनाघन->घनघन
घार->घर
घर्घरक->घर्गरक
घाटाल->घाटल
घूक->घुक
घृष्ठिला->घृष्टिला
घोर->घोण
घौर->घोण
घोरक->घोणक
घ्राति->घ्रति
चक्रपात->चक्रपथ
चक्रपाद->चक्रपद
चक्रावर्त->चक्रवर्त
चक्षुस्->चक्षुश्
चतुःफला->चतुःपला
चतुराध्यायिक->चतुरध्यायिक
चतुस्->चतुश्
चन्दनाय्->चन्दनय्
चन्धनि->चन्दनी
चन्द्रमास->चन्द्रमस
चन्द्रालोक->चन्द्रलोक
चन्द्रावती->चन्द्रवती
चन्द्रवसा->चन्द्रवशा
चमीकार->चमीकर
चमू->चमु
चरण्टी->चरण्टि
चारथ->चराथ
चारुक->चरुक
चारुभद्र->चरुभद्र
चर्मखाण्डिक->चर्मखण्डिक
छलित->चलित
छलितक->चलितक
छलितराम->चलितराम
चालुक्य->चलुक्य
छवि->चवी
चाष->चष
छा->चा
छागलेयिन्->चागलेयिन्
चातुर्मासी->चातुर्मसी
चातुर्वैद्य->चातुर्वेद्य
छत्त्र->चात्त्र
छात्त्र->चात्त्र
छदि->चादि
चारुरूप->चारुरुप
चीय्->चिञ्
चिरि->चिणी
चीरि->चिणी
चीरी->चिणी
चीति->चिती
चित्कार->चित्कण
चीत्कार->चित्कण
छित्ति->चित्ती
चित्रपादा->चित्रपदा
चित्रराति->चित्ररथी
चित्रवाण->चित्रवर
चित्रौदन->चित्रोदन
छिदि->चिदि
चिरान्तक->चिरन्तक
चीरपर्ण->चिरपर्ण
चीरिन्->चिरिन्
चीरिल्लि->चिरिल्ली
चीचीकूची->चीचीकुची
चीभ्->चीब्
चीरिणी->चीरिणि
चुक्रवास्तूक->चुक्रवास्तुक
चुच्चू->चुच्चु
छुच्छू->चुच्चु
चूड->चुड
चूडामणि->चुडामणि
छुड्ड->चुड्ड
छुड्->चुढ्
चुर->चुण
चुण्ढी->चुण्डी
चूति->चुति
चुरी->चुरि
चूरि->चुरि
छुरी->चुरि
छूरी->चुरि
चूरु->चुरु
चूरु->चुरू
चूलक->चुलक
छुरिका->चूरिका
छूरिका->चूरिका
छुरी->चूरी
छूरी->चूरी
छेदि->चेदी
चैत्रकूटी->चैत्रकुटी
छो->चो
चौडि->चोडी
चौदायनि->चोदायनि
चौरी->चोरी
चौलि->चोली
चौलुक्य->चोलुक्य
चौरी->चौरि
च्यौत्न->च्योत्न
छगलाण्ड->छगलण्ड
छागलाण्ड->छगलण्ड
छगलाङ्घ्री->छगलाङ्घ्रि
छागलि->छगली
छाच्छिका->छच्छिका
छत्त्रधार->छत्त्रधर
छत्त्राधान्य->छत्त्रधान्य
छात्त्रि->छत्त्री
छन्दस्->छन्दश्
छान्दोग->छन्दोघ
छान्दोविचित->छन्दोविचित
छिक्कर->छिक्कण
छिक्कार->छिक्कण
छुच्छू->छुच्छु
छेकाल->छेकल
छैदिक->छेदिक
जागरिष्णु->जगरिष्णु
जागर->जगार
जङ्घारि->जङ्गारि
जाङ्गुल->जङ्गुल
जङ्घाल->जङ्घल
जाङ्गल->जङ्घल
जझ्झ्->जज्झ्
जाटिकायन->जटिकायन
जातूकर्णीपुत्र->जतुकर्णीपुत्र
जतूका->जतुका
जातु->जतू
जातू->जतू
जनीय->जनिय
जानु->जनू
जनौ->जनो
जन्माधिप->जन्मदीप
जंपती->जम्पति
जम्बूखण्ड->जम्बुखण्ड
जम्भारि->जम्भरि
जयावती->जयवती
जयावह->जयवह
जयावह->जयवाह
जाया->जया
जारद्वृक्ष->जरद्वृक्ष
जारण->जरर
जरूथ->जरुथ
जलाकर->जलकर
जालकार->जलकर
जलाञ्जलि->जलञ्जलि
जलद्वीप->जलद्विप
जलरूप->जलरुप
जलसूचि->जलशुचि
जविष्ठ->जविष्ट
जागरूक->जागरुक
जाघनी->जाघनि
जाङ्घालायन->जाङ्घलायन
जाटालिका->जाटलिका
जातिसांकर्यवाद->जातिसंकर्यवाद
जातूकर्ण->जातुकर्ण
जाम्बवौष्ठ->जाम्बवोष्ठ
जाम्बील->जाम्बिल
जाम्बूनदमय->जाम्बुनदमय
जारमाण्य->जारमण्य
जारूथी->जारुथी
जालपाद्->जालपद्
जालपाद->जालपद
जालवर्वूरक->जालवर्वुरक
जिङ्गी->जिङ्गि
जीर्वि->जिर्वि
जीव्->जिव्
जीव->जिव
जीवनि->जिवनी
जीवशंस->जिवशंस
जीवजीव->जिवाजीव
जिह्मशी->जिह्मशि
जूक->जुक
जूत->जुत
जूमरनन्दिन्->जुमरनन्दिन्
जुह्वास्य->जुह्वस्य
जैत्र->जेत्र
जैन->जेन
ज्ञास्->ज्ञस्
ज्ञानरत्नावली->ज्ञानरत्नावलि
ज्यानि->ज्ञानी
ज्यैष्ठ्य->ज्येष्ठ्य
ज्योतीरत->ज्योतिरत
ज्योतीरथ->ज्योतिरत
ज्योतिस्->ज्योतिश्
ज्यौतिषिक->ज्योतिषीक
ज्योत्स्नी->ज्योत्स्नि
ज्वालाखरगद->ज्वालखरगद
ज्वालाजिह्व->ज्वालजिह्व
झाट->झट
झर्->झण्
झर->झण
झणत्कार->झणत्कर
झर्झर->झर्जर
झार्झर->झर्जर
झिञ्झिम->झिञ्जिम
झिरिका->झिणिका
झीरिका->झिणिका
झिरी->झिरि
झीरिका->झिरीका
झिल्लीक->झिल्लिक
टाक->टक
ठकार->टकार
टगर->टगण
टांकृत->टंकृत
टीटिभ->टिटिभ
डङ्गारी->डङ्गरी
डाङ्गरी->डङ्गरी
डम्भ्->डंब्
डम्बार->डंबर
डाहल->डहाल
डाकिनी->डाकिनि
ढाल->डाल
डिल्ली->डिल्लि
ढुण्ढि->डुण्ढि
ढाल->ढल
ढुण्ढि->ढुण्डि
तकरी->तकरि
ताक्षशिल->तक्षशिल
तगर->तगण
ताड->तड
ताडका->तडाका
ताण्डिन्->तण्डिन्
ताण्डि->तण्डी
तण्डूलिकाश्रम->तण्डुलिकाश्रम
ताण्ड्यायनी->तण्ड्यायनी
तत्त्वमुक्तावली->तत्त्वमुक्तावलि
तथ्य->तत्य
तात्य->तत्य
तादुरी->तदुरी
तादृश->तदृश
ताद्धर्म्य->तद्धर्म्य
तद्भाव->तद्भव
तनूजन्मन्->तनुजन्मन्
तनूबल->तनुबल
तनूरुह->तनुरुह
तनूकृथ->तनूकृत
तानूनपात->तनूनपात
तन्नी->तन्नि
तपस्->तपश्
तबलाकृति->तबलकृति
तामसवन->तमसावन
तामलकी->तमालकी
तामि->तमी
तामु->तमु
तायादर->तयादर
तारटी->तरटी
तारणि->तरणी
तारारि->तरणी
तारापति->तरपति
ताराज्->तराज्
तारायण->तरायण
तरूट->तरुट
तरुतूलिका->तरुतुलिका
तर्कारी->तर्कारि
तार्णक->तर्णक
तर्दू->तर्दु
तालवन->तलवन
तालशब्द->तलशब्द
तालक->तलाक
ताव्->तव्
तापायन->तापयान
ताम्बूलिक->ताम्बुलिक
ताम्रकूट->ताम्रकुट
ताम्रपात्र->ताम्रपत्र
ताम्रावती->ताम्रवती
तारावर्ष->तारवर्ष
तार्क्षाक->तार्क्षक
तार्तीय->तार्तिय
तार्तीयीक->तार्तीयिक
तालाङ्क->तालङ्क
तिणिस->तिणिश
तिथि->तिति
तीर->तिर
तिरश्ची->तिरश्चि
तिरस्कारिणी->तिरस्करिणी
तिरीट->तिरिट
तिलकाय्->तिलकय्
तिलौदन->तिलोदन
तीर्थराजी->तीर्थराजि
तूख->तुक
तुर->तुण
तूण->तुण
तूर->तुण
तूणव->तुणव
तूणीर->तुणीर
तुभ्->तुब्
तुभ->तुब
तूबर->तुबर
तूबरक->तुबरक
तूरा->तुरा
तूर्वयाण->तुर्वयण
तूर्वि->तुर्वी
तूल->तुल
तूलक->तुलक
तुलसी->तुलसि
तूलि->तुली
तूवरिका->तुवरिका
तुवीरव->तुविरव
तुस->तुश
तूरा->तूणा
तूलनाली->तूलनालि
तृणकुटी->तृणकुटि
तृणपूलक->तृणपुलक
तृणपूली->तृणपुली
तृफला->तृपला
तृम्फण->तृम्पण
तेजःफल->तेजःपाल
तेदनी->तेदनि
तैलचौरिका->तैलचोरिका
तोयनीवी->तोयनिवी
तोयाधिवासिनी->तोयादिवासिनी
तौरयाण->तौरयण
त्याजन->त्यजन
त्रख्->त्रक्
त्रयस्->त्रयश्
त्रयीविद->त्रयिविद
त्रायन्ती->त्रायन्ति
त्रिफल->त्रिपल
त्रिपुटीफल->त्रिपुटिफल
त्रिपृष्ठ->त्रिपृष्ट
त्रिभण्डी->त्रिभण्डि
त्रिभाव->त्रिभव
त्रिवेणी->त्रिवेणि
त्रिशाण->त्रिशर
त्रिसर->त्रिशर
त्रिशाल->त्रिशल
त्रिसाहस्र->त्रिसहस्र
त्रैध->त्रेध
त्र्याक्षायण->त्र्यक्षायण
त्र्यस्र->त्र्यश्र
त्र्यहीन->त्र्यहिन
त्र्युदाय->त्र्युदय
त्वाष्ट्र->त्वष्ट्र
त्वै->त्वे
थूथू->थुथु
दंसि->दंशी
दह्->दः
दाक्षक->दक्षक
दक्षिणाबन्ध->दक्षिणबन्ध
दाक्षि->दक्षी
दाक्ष्य->दक्ष्य
दाडी->दडी
दाण्डपाता->दण्डपाता
दत्ताक्षर->दत्तक्षण
दत्तामित्र->दत्तमित्र
दधित्थ->ददित्थ
दाधित्थ->ददित्थ
दधिसर->दधिशर
दधिसार->दधिशर
दन्तपाली->दन्तपालि
दन्ताली->दन्तालि
दान्ति->दन्ती
दन्तूल->दन्तुल
दन्तोलूखलिक->दन्तोलुखलिक
दन्दशूक->दन्दशुक
दभीति->दभिति
दामनि->दमनी
दामनी->दमनी
दामनीय->दमनीय
दाय->दय
दायित->दयित
दारक->दरक
दरीमुख->दरिमुख
दारि->दरी
दारी->दरी
दर्भ->दर्ब
दार्भ->दर्ब
दर्भट->दर्बट
दर्भि->दर्बि
दार्भि->दर्बि
दर्भर->दर्भण
दर्वीकर->दर्विकर
दार्विका->दर्विका
दार्शपौर्णमासिक->दर्शपौर्णमासिक
दालि->दली
दाल्भि->दल्भि
दाशत्व->दशत्व
दासत्व->दशत्व
दशपूरुष->दशपुरुष
दशरथललिताव्रत->दशरथललितव्रत
दाशरात्रिक->दशरात्रिक
दशावर->दशवार
दशसाहस्र->दशसहस्र
दशास्य->दशस्य
दासी->दशि
दसेरक->दशैरक
दाशेरक->दशैरक
दासेरक->दशैरक
दस्र->दश्र
दास्र->दश्र
दासी->दसि
दाशु->दसु
दाक्षायण->दाक्षयाण
दाय्->दाञ्
दाडी->दाडि
दार->दाण
दारि->दाणि
दारी->दाणि
दार्भायण->दार्भयण
दार्वीहौमिक->दार्विहोमिक
दासी->दाशी
दासुर->दाशूर
दासी->दासि
दीक्ष्->दिक्ष्
दीक्षणीय->दिक्षणीय
दीक्षा->दिक्षा
दीक्षापति->दिक्षापति
दिण्डीर->दिण्डिर
दिधि->दिदी
दीदि->दिदी
दीदी->दिदी
दीधी->दिदी
दिधीषू->दिधिषू
दिधीषू->दिधीषु
दीनार->दिनार
दिव्यौघ->दिव्योघ
दीस->दिश
दीधी->दीधि
दीर्घकण्ठ->दीर्घकण्ट
दीर्घायुस्->दीर्घयुस्
दुःख->दुःक
दुःखाकर->दुःखकर
दुःशास->दुःशस
दुःशासन->दुःशसन
दुध्->दुद्
दुध्रुक्षु->दुद्रुक्षु
दुराधी->दुराधि
दुरूह->दुरुह
दुर्गादत्त->दुर्गदत्त
दुर्गादास->दुर्गदास
दुर्धर->दुर्दार
दुर्दुरूट->दुर्दुरुट
दुर्धुरूट->दुर्दुरुट
दूर्व->दुर्व
दुर्वाचकयोग->दुर्वचकयोग
धूर्वी->दुर्वी
दुर्हार्द्->दुर्हर्द्
धूलि->दुली
धूली->दुली
दुस्->दुश्
धूश्->दुश्
दूष->दुष
दुष्टरीतु->दुष्टरितु
दुस्त्याज्य->दुस्त्यज्य
धूति->दूति
दूतीका->दूतिका
दूतीत्व->दूतित्व
धूति->दूती
दूराध->दूरद
दूरपात->दूरपथ
दूरापात->दूरपथ
धुरा->दूरा
दूलास->दूलाश
धूलि->दूली
धूली->दूली
धूष्->दूष्
दूषीका->दूषिका
धृक्->दृक्
धृत->दृत
दृशद्वती->दृशद्वति
धृष्टकेतु->दृष्टकेतु
धृष्टरथ->दृष्टरथ
धृष्टशर्मन्->दृष्टशर्मन्
दैवतस्->देवतस्
देवनदी->देवनदि
दैवपर->देवपर
दैवस्थानि->देवस्थानि
दैवातिथ->देवातिथ
दैवाप->देवाप
दैवारिप->देवारिप
देहली->देहलि
दैवादिक->दैवदिक
दौःसाधिक->दोःसाधिक
दोध->दोद
दौर्मद्य->दोर्मध्य
दोषाकर->दोषकर
द्यावाभूमी->द्यावाभूमि
द्रुह्->द्रुः
द्रौणायनि->द्रोणायनि
द्रौणि->द्रोणी
द्रौणी->द्रोणी
द्वारिन्->द्वरिन्
द्वादशवार्षिक->द्वादशवर्षिक
द्वादशास्रि->द्वादशाश्रि
द्वारावती->द्वारवती
द्विचात्वारिंशिक->द्विचत्वारिंशिक
द्वीड->द्विढ
द्विपारि->द्विपरि
द्विपृष्ठ->द्विपृष्ट
द्विरदान्तक->द्विरदन्तक
द्विरभ्यासाकूपार->द्विरभ्यासाकूपर
द्विरूढा->द्विरुढा
द्वैतवन->द्वेतवन
द्वैध->द्वेद
द्वैधीभाव->द्वैधिभाव
धाटी->धटी
धर->धण
धार->धण
धनच्छू->धनच्छु
धनाश्री->धनश्री
धनीका->धनिका
धानिका->धनिका
धनुःखण्ड->धनुःकाण्ड
धानुष्करि->धनुष्करी
धानेय->धनेय
धामनिका->धमनिका
धामनी->धमनी
धाणक->धरक
धारक->धरक
धरणीधृत्->धरणिधृत्
धरणीभृत्->धरणिभृत्
धरणीरुह->धरणिरुह
धरणीसुत->धरणिसुत
धारणि->धरणी
धरणीपूर->धरणीपुर
धारयत्कवि->धरयत्कवि
धारा->धरा
धराधारा->धराधरा
धाराफल->धरापाल
धर्मधृक्->धर्मदृक्
धर्मरथ->धर्मरत
धार्मविद्य->धर्मविद्य
धर्माम्भोधि->धर्माम्बोधि
धावन->धवन
धवनी->धवनि
धावनि->धवनि
धारिका->धाणिका
धातुकासीस->धातुकाशीश
धात्री->धात्रि
धान्यकोष्ठक->धान्यकोष्टक
धान्याद->धान्यद
धान्यमाय->धान्यमय
धामसाच्->धामसच्
धारणापारणव्रत->धारणपारणव्रत
धारापात->धारापथ
धितावन्->धितवन्
धीतीका->धीतिका
धीरस्कन्ध->धीरस्कन्द
धीलटी->धीलटि
धूत->धुत
धूतपाप->धुतपाप
धूति->धुति
धून->धुन
धूनन->धुनन
धूनन->धुनान
धून्वन्त्->धुन्वन्त्
धूर्वी->धुर्वी
धूमावती->धूमवती
धूर्षाह्->धूर्षह्
धूलीमय->धूलिमय
धूस्तूर->धूस्तुर
धौर->धोर
धौरितक->धोरितक
धौतरी->धौतरि
ध्वंसि->ध्वंशि
ध्वंसि->ध्वंशी
ध्वजाहृत->ध्वजहृत
नल->नLअ
नाल->नLअ
नह्->नः
नकार->नकर
नखर->नकर
नाकुलि->नकुली
नक्षत्रवीथी->नक्षत्रवीथि
नखारि->नखरी
नखालु->नखलु
नागर्य->नगण्य
नागराज->नगराज
नगारि->नगरी
नागारि->नगरी
नागाधिराज->नगाधिराज
नागेश्वर->नगेश्वर
नाग्नजित->नग्नजित
नाचिकेत->नचिकेत
नाचीन->नचीन
नडस->नडश
नाडायन->नडायन
नाथ्->नत्
नात्र->नत्र
नदीज->नदिज
नादि->नदी
नाद्य->नद्य
नाध्->नध्
नानन्द->ननन्द
नान्दिकर->नन्दिकर
नन्दीपुर->नन्दिपुर
नान्दीपुर->नन्दिपुर
नान्दी->नन्दी
नभस्->नभश्
नाभि->नभि
नाम->नम
नामक->नमक
नमात्र->नमत्र
नामक->नमाक
नाम्ब->नम्ब
नरकावास->नरकवास
नरायण->नरयाण
नारायण->नरयाण
नारसिंहचूर्ण->नरसिंहचूर्ण
नारसिंह->नरसिम्ह
नाराच->नराच
नारिष्ठ->नरिष्ट
नारीष्ठ->नरिष्ट
नारीष्टा->नरिष्ठा
नारी->नरी
नार्कुट->नर्कुट
नर्तू->नर्तु
नर्मरा->नर्मणा
नालिका->नलिका
नालिनी->नलिनि
नालिनी->नलिनी
नालि->नली
नलोपाख्यान->नलोपख्यान
नवज्वार->नवज्वर
नवरात्र->नवरत्र
नासिक->नशीक
नाशुक->नशुक
नासा->नसा
नागारि->नागरी
नागवीथी->नागवीथि
नागोजी->नागोजि
नारी->नाणी
नान्दी->नान्दि
नाभानेदिष्ठ->नाभानेदिष्ट
नामधेय->नामदेय
नामसारोद्धार->नामसारोद्धर
नामावली->नामावलि
नारी->नारि
नारिष्ठ->नारिष्ट
नारीष्ठ->नारिष्ट
नारीष्ठ->नारीष्ट
नालकिनी->नालकिनि
नासाछिन्नी->नाशाछिन्नी
नासिका->नाशिका
नासीर->नाशिर
नासीर->नासिर
निःशूक->निःशुक
निःसुख->निःशुक
निःसाण->निःसर
निःसार->निःसर
निकारण->निकरण
निगार->निगर
निगूहन->निगुहन
नितत्नी->नितत्नि
नित्यायुक्त->नित्ययुक्त
निधि->निदी
निनादिन्->निनदिन्
निपाक->निपक
निपात्य->निपत्य
निभ->निब
निम्लोचनी->निम्लोचनि
निरञ्छन->निरञ्चन
निरापद्->निरपद्
निरायति->निरयति
निराशा->निरसा
निरस्थि->निरस्ति
निराकाङ्क्ष->निराकङ्क्ष
निरामिषाशिन्->निरामिषशिन्
निरासन->निराशन
निरासित्व->निराशित्व
निराहावन्त्->निराहवन्त्
निरीक्षक->निरिक्षक
निर्घात->निर्गत
निर्गुण्डी->निर्गुण्डि
निर्ज्ञाति->निर्ज्ञति
निर्भर->निर्बाण
निर्माद्->निर्मद्
निर्माली->निर्मली
निर्वाच्->निर्वच्
निर्वाञ्च्->निर्वञ्च्
निर्वास->निर्वश
निर्वाणपूरण->निर्वाणपुराण
निर्वीर->निर्विण
नीलङ्गु->निलङ्गु
नीलाङ्गु->निलङ्गु
नीव->निव
नीवि->निवि
नीवी->निवि
नीवि->निवी
नीवी->निवी
निशठ->निशट
निशाट->निशट
निशादि->निशदि
निशादि->निशधि
नीषह्->निषह्
निष्कासित->निष्काशित
निष्ठीव->निष्टीव
निष्ठावन्त्->निष्ठवन्त्
निष्ठीव->निष्ठिव
निष्ठीवन->निष्ठिवन
निष्फलय्->निष्पलाय्
निष्प्रतीकार->निष्प्रतिकार
नील->नीLअ
नीरूप->नीरुप
नीलपृष्ठ->नीलपृष्ट
नृकेसरिन्->नृकेशरिन्
नृकेसरि->नृकेशरी
नैश->नेश
नैरूहिक->नैरुहिक
नैर्झर->नैर्जर
नैष्ठिक->नैष्टिक
न्यासिन्->न्यसिन्
न्यासादेशविवरण->न्यासदेशविवरण
पक्वसस्योपमोन्नति->पक्वशस्योपमोन्नति
पक्षवाद->पक्षवध
पङ्कसूरण->पङ्कशूरण
पङ्गुग्राह->पङ्गुग्रह
पचप्रकूटा->पचप्रकुटा
पञ्चाज->पञ्चज
पञ्चपात्र->पञ्चपत्र
पञ्चप्रासाद->पञ्चप्रसाद
पञ्चाशति->पञ्चशती
पञ्चशैरीषक->पञ्चशैरिषक
पञ्चौदन->पञ्चोदन
पटकुटी->पटकुटि
पठि->पटी
पटौर->पटोर
पट्टीश->पट्टिस
परकाल->पणकाल
परता->पणता
परत्व->पणत्व
परम्->पणम्
पणास्थि->पणस्थि
पराधि->पणादि
परायति->पणायति
परार्ध->पणार्ध
पण्याजीव->पण्यजीव
पण्यवीथी->पण्यवीथि
पथिक->पतिक
पतितसावित्रीक->पतितसवित्रीक
पतीय्->पतिय्
पतिवती->पतिवति
पत्त्राली->पत्त्रली
पत्त्री->पत्त्रि
पदायत->पदयात
पदवी->पदवि
पदष्ठीव->पदष्टीव
पद्मनाभद्वादशी->पद्मनाभद्वदशी
पद्मभास->पद्मभाश
पद्मावती->पद्मवती
पयःपारावार->पयःपारावर
पयस्->पयश्
पयोधा->पयोदा
पराजित्->परजित्
परादन->परधन
परादान->परधन
पराभूति->परभूति
परमार->परमर
परमार्थ->परमार्त
परावृत्->परवृत्
परस्->परश्
परस्व->परश्व
परसंचारक->परसंचरक
परारि->पराणी
पराप्रासादमन्त्र->पराप्रसादमन्त्र
पाराशर->परासर
परिक्षाण->परिक्षण
परीक्षण->परिक्षण
परीक्षित->परिक्षित
पारिक्षित->परिक्षित
पारीक्षित->परिक्षित
पाणिक->परिख
पारिख->परिख
परिघात->परिगत
पाणिघात->परिगत
पारिजात->परिजात
परीणस्->परिणश्
परित्याजन->परित्यजन
परिधीपतिखेचर->परिधिपतिखेचर
परिपाचन->परिपचन
परिपान->परिपन
परिपाटी->परिपाटि
परिप्री->परिप्रि
पारिभाव्य->परिभाव्य
परिभू->परिभु
पाणिभुज्->परिभुज्
परीमन्->परिमन्
पारिमाण्डल्य->परिमाण्डल्य
पारिमाण्य->परिमाण्य
पाणिमुक्त->परिमुक्त
पाणिमुख->परिमुख
पारियानिक->परियानिक
परिवाप्य->परिवप्य
परिवार->परिवाण
परिवी->परिवि
परिव्राज्->परिव्रज्
पारिव्रज्य->परिव्राज्य
पारिव्राज्य->परिव्राज्य
परिस्रुत्->परिश्रुत्
परिषूति->परिषुति
परीसार->परिसार
पारिहास्य->परिहास्य
पाणि->परी
पारी->परी
पाणिवाद->परीवाद
परीसार->परीसर
परुःस्रंस->परुःश्रंस
परूषक->परुषक
पारुषक->परुषक
पारु->परू
पर्णवी->पर्णवि
पाण्य->पर्य
पार्य->पर्य
पर्यूषणाष्टाह्निका->पर्युषणाष्टाह्निका
पार्वति->पर्वति
पार्वति->पर्वती
पर्वस->पर्वश
पर्शूल->पर्शुल
पार्षी->पर्षि
पालक्क->पलक्क
पालाशि->पलाशी
पालिका->पलिका
पाल्वलतीर->पल्वलतीर
पावा->पवा
पाव्य->पव्य
पाश->पश
पास->पश
पाशुक->पशुक
पाशुपाल्य->पशुपाल्य
पशुहरीतकी->पशुहरितकी
पश्चिमानूपक->पश्चिमानुपाक
पष्ठवाह्->पष्टवह्
पष्ठवाह्->पष्ठवह्
पाश->पस
पास->पस
पाशी->पसि
पांसव->पांशव
पांसुकासीस->पांशुकासीस
पांसुकुली->पांशुकुली
पांसुकूल->पांशुकूल
पांसुक्षार->पांशुक्षार
पांसुचत्वर->पांशुचत्वर
पांसुचन्दन->पांशुचन्दन
पांसुचामर->पांशुचामर
पांसुज->पांशुज
पांसुमर्दन->पांशुमर्दन
पांसुर->पांशुर
पांसुरागिणी->पांशुरागिणी
पांसुराष्ट्र->पांशुराष्ट्र
पांसुल->पांशुल
पांसुव->पांशुव
पांसुकासीस->पांसुकसीस
पाकारु->पाकरु
पाची->पाचि
पाञ्चाल्य->पाञ्चल्य
पाठ->पाट
पाठिका->पाटिका
पाटूर->पाटुर
पारक->पाणक
पाणिघात->पाणिगत
पाणीतल->पाणिताल
पारी->पाणी
पाणौकरण->पाणोकरण
पाथोधर->पाथोदर
पादपीठ->पादपीट
पादशस्->पादशश्
पानीयवर्णिका->पानियवर्णिका
पानीयफल->पानीयपल
पान्नागारि->पान्नगारि
पापकारिन्->पापकरिन्
पापाय्->पापय्
पारापार->पारपार
पारमार्थिक->पारमर्थिक
पारमैश्वर्य->पारमेश्वर्य
पारंपरीण->पारंपरिण
पारलौकिक->पारलोकिक
पारस->पारश
पाराशर्य->पारशर्य
पारावार->पारावर
पारी->पारि
पारीक्षित्->पारिक्षित्
पारिभाव्य->पारिभव्य
पारिमाण्डल्य->पारिमण्डल्य
पार्श्वैकादशी->पार्श्वेकादशी
पार्ष्ठिक->पार्ष्टिक
पार्ष्णिवाह्->पार्ष्णिवह्
पालाशक->पालशक
पालिन्धी->पालिन्दि
पालिन्धी->पालिन्दी
पाशुपाल्य->पाशुपल्य
पाहात->पाहत
पिच्छ->पिच्च
पिञ्जूल->पिञ्जुल
पीठ->पिठ
पीठक->पिठक
पीड्->पिड्
पीड->पिड
पीडा->पिडा
पीड->पिढ
पिण्डारक->पिण्डरक
पिण्डस->पिण्डश
पिण्डाश->पिण्डश
पितुभाज्->पितुभज्
पितृरूप->पितृरुप
पितृहू->पितृहु
पित्तातीसार->पित्तातिसार
पिपासावन्त्->पिपासवन्त्
पिप्पलू->पिप्पलु
पिष्टपूर->पिष्टपुर
पीथि->पीती
पू->पु
पुंस्->पुंश्
पुच्छाण्डक->पुच्छण्डक
पुञ्जील->पुञ्जिल
पुर->पुण
पूर->पुण
पुरक->पुणक
पूरक->पुणक
पुरिका->पुणिका
पुत्रपौत्र->पुत्रपोत्र
पुत्रान्नाद->पुत्रान्नद
पूत->पुथ
पूति->पुथि
पुनरुपागम->पुनरुपगम
पुनर्भार्या->पुनर्भर्या
पुप्फुस->पुप्पुस
पुरवासिन्->पुरवसिन्
पुरस्->पुरश्
पूरणीय->पुराणीय
पुरीकय->पुरिकाय
पुरीषाधान->पुरीषधान
पुरूतम->पुरुतम
पुरूरवस्->पुरुरवस्
पुरूवसु->पुरुवसु
पुरुशाक->पुरुशक
पुरुषाजान->पुरुषजन
पुरुषांसक->पुरुषांशक
पूरु->पुरू
पुरोधस्->पुरोदास्
पूर्व->पुर्व
पूलिका->पुलिका
पूलिका->पुलीका
पुष्करसाद->पुष्करसद
पुष्पकासीस->पुष्पकासीश
पुष्पावती->पुष्पवती
पूजाखण्ड->पूजाकाण्ड
पूय्->पूञ्
पूर->पूण
पूथिका->पूतिका
पूतिसृञ्जय->पूतिशृञ्जय
पूथिका->पूतीका
पूर्वथा->पूर्वता
पूर्वातिथि->पूर्वतिथि
पूर्वभाज्->पूर्वभज्
पूर्वभाव->पूर्वभव
पूर्वसक्थ->पूर्वशक्थ
पृथुश्रवस्->पृतुश्रवस्
पृथूदर->पृथुधार
पृष्ठज->पृष्टज
पृष्ठवाह्->पृष्ठवह्
पैठिक->पेटिक
पेशस्कारी->पेशस्करी
पैङ्गलौदायनि->पैङ्गलोदायनि
पैङ्गलौदायनि->पैङ्गलौदयनि
पैठकलायन->पैटकलायन
पैठीनसि->पैठिनसि
पोथकी->पोतकी
पोताल->पोतल
पोथकी->पोथकि
पौतिक->पोथिक
पौरक->पोरक
पौञ्जिष्ठ->पौञ्जिष्ट
पौण्ड्रमात्स्यक->पौण्ड्रमत्स्यक
पौरुषांसकिन्->पौरुषांशकिन्
पौरोधस->पौरोदाश
पौरोभाग्य->पौरोबाग्य
पौष्टी->पौष्टि
प्रकाशेतर->प्रकशेतर
प्रखल->प्रकाल
प्रकृतिभाव->प्रकृतिभव
प्रगाथ->प्रगत
प्रघात->प्रगत
प्रगाहण->प्रगहण
प्रचारित->प्रचरित
प्रजनू->प्रजनु
प्रणाली->प्रणालि
प्रणी->प्रणि
प्रतान्->प्रतन्
प्रताम्->प्रतम्
प्रतमाम्->प्रतमम्
प्रतिकारिन्->प्रतिकरिन्
प्रतिघात->प्रतिगत
प्रतिथि->प्रतिती
प्रतिधा->प्रतिदा
प्रतिप्राश्->प्रतिप्रश्
प्रतिबाधक->प्रतिबधक
प्रतिरथ->प्रतिरत
प्रतिवाच्->प्रतिवच्
प्रतिष्ठान->प्रतिष्ठन
प्रातिष्ठित->प्रतिष्ठित
प्रतिसामन्त->प्रतिसमन्त
प्रतिस्पाशन->प्रतिस्पशान
प्रातिहत->प्रतिहत
प्रतिहार->प्रतिहर
प्रतीहार->प्रतिहर
प्रातिहार->प्रतिहर
प्राति->प्रती
प्रतीची->प्रतीचि
प्रथिष्ठ->प्रतीष्ट
प्रतोली->प्रतोलि
प्रत्यक्स्रोतस्->प्रत्यक्श्रोतस्
प्रात्यन्तिक->प्रत्यन्तिक
प्रत्यायितव्य->प्रत्ययितव्य
प्रत्याश्राव->प्रत्यश्रव
प्रत्युद्घात->प्रत्युद्गत
प्राथमकल्पिक->प्रथमकल्पिक
प्रथमभाज्->प्रथमभज्
प्रथिवी->प्रथिवि
प्रथिष्ठ->प्रथिष्ट
प्रदाम्->प्रदम्
प्रधारण->प्रदारण
प्रधि->प्रदी
प्रधी->प्रदी
प्रदेशिनी->प्रदेशिनि
प्राद्योति->प्रद्योति
प्राध्वन->प्रध्वान
प्रापणिक->प्रपाणिक
प्रापणीय->प्रपाणीय
प्रपूरण->प्रपुराण
प्रभु->प्रबू
प्रभू->प्रबू
प्रभाज्->प्रभज्
प्रभावन्त्->प्रभवन्त्
प्रभृथ->प्रभृत
प्राभृत->प्रभृत
प्रमर->प्रमण
प्रमाण->प्रमण
प्रमार->प्रमण
प्रमथ->प्रमत
प्रमाथ->प्रमत
प्रामति->प्रमती
प्रामति->प्रमथि
प्रमाथिन्->प्रमथिन्
प्रामति->प्रमाथी
प्रामाद्य->प्रमाद्य
प्रमी->प्रमि
प्रमीय->प्रमिय
प्रायु->प्रयु
प्रायोक्त्र->प्रयोक्त्र
प्राणथ->प्ररथ
प्ररूढ->प्ररुढ
प्रलम्भ->प्रलंब
प्रालम्ब->प्रलंब
प्रलयाकल->प्रलयकाल
प्रवाच्->प्रवच्
प्रवाणि->प्रवणी
प्रावणि->प्रवणी
प्रवाद्य->प्रवध्य
प्रावन्->प्रवन्
प्रावरणीय->प्रवरणीय
प्रवर्धक->प्रवर्दक
प्रावहणि->प्रवहणी
प्रावाहणि->प्रवहणी
प्रावणि->प्रवाणी
प्रावहणि->प्रवाहणी
प्रावाहणि->प्रवाहणी
प्रावी->प्रवि
प्रावी->प्रवी
प्रावृत->प्रवृत
प्रावृष्->प्रवृष्
प्रव्याहार->प्रव्यहार
प्रव्राज्->प्रव्रज्
प्राव्राज्य->प्रव्रज्य
प्राव्राज्य->प्रव्राज्य
प्रस्->प्रश्
प्राश्->प्रश्
प्रशंसन->प्रशंशन
प्रशंसा->प्रशंशा
प्रसक्ति->प्रशक्ति
प्रसाद्->प्रशद्
प्रशाम्->प्रशम्
प्रसामि->प्रशमी
प्रशासन->प्रशसन
प्रशासितर्->प्रशसितर्
प्रसातिका->प्रशातिका
प्रसित->प्रशित
प्राशित->प्रशित
प्रसित->प्रशीत
प्राशित->प्रशीत
प्रसून->प्रशून
प्रष्ठवाह्->प्रष्ठवह्
प्राश->प्रस
प्रास->प्रस
प्रसङ्गरत्नावली->प्रसङ्गरत्नावलि
प्रासङ्ग->प्रसङ्घ
प्रसाद्->प्रसद्
प्रसू->प्रसु
प्राशु->प्रसु
प्राशू->प्रसु
प्रसूति->प्रसुति
प्रस्थावन्त्->प्रस्थवन्त्
प्रस्वापन->प्रस्वपन
प्रहाणि->प्रहणि
प्राहणि->प्रहणि
प्राहारिक->प्रहणीक
प्रहरणीय->प्रहरणिय
प्रहाणि->प्रहरी
प्राहणि->प्रहरी
प्राहणि->प्रहारि
प्रह्वाय->प्रह्वय
प्रह्वलीका->प्रह्वलिका
प्राक्स्रोतस्->प्राक्श्रोतस्
प्राग्भाव->प्राग्भव
प्राछ्->प्राच्
प्राणदावन्त्->प्राणदवन्त्
प्राणनाथ->प्राणनथ
प्रातिहार->प्रातिहर
प्राधा->प्रादा
प्रायस्->प्रायश्
प्राव्राज्य->प्राव्रज्य
प्रासह्->प्राशः
प्रासक->प्राशक
प्रासह्->प्रासः
प्राहारिक->प्राहरिक
प्रियधा->प्रियदा
प्रियभाषिन्->प्रियभषिन्
प्रियवाद->प्रियवद
प्रेतावास->प्रेतवश
प्रेतीषणि->प्रेतिषणि
प्रैण्->प्रेर्
प्रैषणिक->प्रेषणिक
प्रेष्ठ->प्रेष्ट
प्रेहिवाणिजा->प्रेहिवणिजा
प्रौढ->प्रोढ
प्रौढपाद->प्रोढपाद
प्रौढि->प्रोढि
प्रोण्ठ->प्रोण्ट
प्रोन्माथिन्->प्रोन्मथिन्
प्लक्षप्रस्रवण->प्लक्षप्रश्रवण
प्लीहा->प्लिहा
फञ्जी->फञ्जि
फणी->फणि
फाणि->फणि
फणिकेसर->फणिकेशर
फाणित->फणित
फारिव->फरिव
फालखेला->फलखेला
फलस->फलश
फाल्गुनि->फल्गुनि
फाल्गुनि->फल्गुनी
बह्->बः
भङ्ग->बङ्ग
भट्ट->बट्ट
भट्टस्वामिन्->बट्टस्वामिन्
भट्->बठ्
भट->बठ
बाड्->बड्
भण्->बण्
भर्->बण्
बर->बण
बाण->बण
बार->बण
भण->बण
भर->बण
भण्ट्->बण्ट्
बाध->बद
बादरि->बदरी
बाध->बध
बाधक->बधक
भदाक->बधक
बाध्य->बध्य
भद्र->बध्र
भन्->बन्
बन्दिग्राह->बन्दिग्रह
बान्धकि->बन्धकी
बान्धकि->बन्धाकि
बभ्रुवाहन->बब्रुवाहन
बाबर->बभार
बाभ्रव->बभ्रव
भम्भ->बम्ब
बम्भराली->बम्भरालि
भम्भराली->बम्भरालि
भम्भराली->बंभराली
भरम->बरम
बर्बरीक->बर्बरिक
भर्व्->बर्व्
बलाक->बलक
बालक->बलक
बलाकाश्व->बलकाश्व
बलाय->बलय
बलवीर्य->बलविर्य
बालशर्मन्->बलशर्मन्
बालाकि->बलाकि
बलीन->बलिन
बालिमन्->बलिमान्
बालिश->बलिश
बालीश->बलिश
बलीह->बलिह
भल्लवि->बल्लवी
भल्लुक->बल्लुक
भल्लूक->बल्लुक
भष्->बष्
भस्->बस्
बस्तवासिन्->बस्तवाशिन्
बाह->बह
बाहव->बहव
बाहदुर->बहादुर
बाहादुर->बहादुर
बहिस्->बहिश्
बहुतराम्->बहुतरम्
बाहुदन्तक->बहुदन्तक
बहुधेय->बहुदेय
बहुधान्य->बहुधन्य
बहुधार->बहुधर
बहुपाय्य->बहुपय्य
बाहुलि->बहुली
बहुसुत->बहुशुत
बह्रामखान->बह्रमखान
बह्वजाविक->बह्वजविक
भा->बा
बाजबाहादुरचन्द्र->बाजबहादुरचन्द्र
बाढ->बाड
भड->बाड
भडित->बाडित
भरस्->बाणस्
बाणासन->बाणसन
भरणि->बाणारि
भरि->बाणि
भरिणी->बाणिणी
भरि->बाणी
भदन्त->बाधान्त
भव->बाव
बाष्पीका->बाष्पिका
बाहीक->बाहिक
बीजकोश->बिजकोश
बुध->बुद
बूष->बुष
बृसी->बृशी
बृहत्सामन्->बृहत्समन्
बृहद्ग्रावन्->बृहद्ग्रवन्
बृहद्ध्वनी->बृहद्ध्वनि
बृहद्भानु->बृहद्बानु
बृहन्नारायणोपनिषद्->बृहन्नारयणोपनिषद्
बैजवापायन->बैजवापयन
बौधायनीय->बोधायनीय
ब्राह्मण->ब्रह्मण
ब्राह्मणसात्->ब्रह्मणसात्
ब्राह्मलौकिक->ब्रह्मलौकिक
ब्रह्मवध्या->ब्रह्मवद्या
ब्राह्माणी->ब्राह्मणि
ब्राह्माणी->ब्राह्मणी
भाकुट->भकूट
भाकूट->भकूट
भक्तिरत्नावली->भक्तिरत्नावलि
भक्षाली->भक्षालि
भागधेय->भगधेय
भागलि->भगाली
भट्टारक->भट्टरक
भरित->भणित
भद्रकार->भद्रकर
भद्रपीठ->भद्रपिठ
भद्रपीठ->भद्रपीट
भद्रवाच्->भद्रवच्
भद्रावती->भद्रवती
भद्रशाख->भद्रशाक
भन्ध्रुक->भन्द्रुक
भम्भारव->भम्भराव
भरद्वाज->भरद्वज
भर्म्याश्व->भर्म्यश्व
भस्मसात्->भस्मसत्
भागीरथ->भागिरथ
भानुजीदीक्षित->भानुजिदीक्षित
भारवाह->भारवह
भारूप->भारुप
भाष्यकार->भाष्यकर
भीरु->भिरु
भीरुकच्छ->भिरुकच्छ
भीमादेव->भीमदेव
भुक्त्वासुहित->भुक्त्वसुहित
भुजगाभोजिन्->भुजगभोजिन्
भूरि->भुरि
भूरिज->भुरिज
भूरिषह्->भुरिषह्
भूर्ज->भुर्ज
भूशुण्डी->भुशुण्डी
भूसुर->भुसुर
भूखण्ड->भूकाण्ड
भूतवाहनसारथि->भूतवाहनसरथि
भूपाल->भूपल
भूफल->भूपल
भूपाटली->भूपाटलि
भूमीरुह->भूमिरुह
भूयस्तराम्->भूयस्तरम्
भृङ्गारीट->भृङ्गरिट
भृङ्गारीट->भृङ्गरीट
भृङ्गार->भृङ्गाण
भृङ्गीरिटि->भृङ्गिरीटि
भैरिक->भेरीक
भोगावती->भोगवती
भोगावली->भोगावलि
भोगीन्द्र->भोगिन्द्र
भौरिक्या->भौणिक्या
भ्राज->भ्रज
भ्राजिष्ठ->भ्रजिष्ठ
भ्रान्तिमन्त्->भ्रन्तिमन्त्
भ्रमरविलसित->भ्रमणविलसित
भ्रमत्कुटी->भ्रमत्कुटि
भ्राश्य->भ्रस्य
भ्रू->भ्रु
भ्रूकुंश->भ्रुकुंस
भ्रुकुटीमुख->भ्रुकुटिमुख
भ्रूकुटि->भ्रुकुटी
भ्लाश्->भ्लश्
भ्लास्->भ्लश्
मक्षीका->मक्षिका
मङ्ख->मङ्क
मङ्गलादेशवृत्त->मङ्गलदेशवृत्त
मङ्गलाव्रत->मङ्गलव्रत
मज्जारस->मज्जरस
मञ्चयाय्य->मञ्चयय्य
मञ्जरीनम्र->मञ्जरिनम्र
मञ्जुभाषिन्->मञ्जुभषिन्
मञ्जूषक->मञ्जुषक
मठ->मट
मठोशीलोठिका->मठोशिलोठिका
मडार->मडर
मणीचक->मणिचक
मणिपाली->मणिपालि
मणिमन्थ->मणिमन्त
मणीवक->मणिवक
मथा->मता
मथि->मती
मथ्र->मत्र
मथुरानाथ->मथुरनाथ
मधुर->मदुर
मधुपर्णी->मधुपर्णि
मधुमथ्->मधुमत्
मधुमल्ली->मधुमल्लि
मधुश्रेणी->मधुश्रेणि
मध्यमखण्ड->मध्यमकाण्ड
मध्यमवाह्->मध्यमवह्
मध्वर्णस्->मध्वर्णश्
मनःसिल->मनःशिल
मनःसुख->मनःशूक
मनस्->मनश्
मनोहारी->मनोहरी
मनोहारी->मनोहारि
मन्था->मन्ता
मन्दादर->मन्दधार
ममाथ->ममथ
मयोभू->मयोभु
मारि->मरि
मारि->मरी
मारीचि->मरीछि
मार्कटि->मर्कटी
मार्ग->मर्ग
मर्जू->मर्जु
मार्जक->मर्झक
मार्ष्टि->मर्ष्टि
मलकोष्ठक->मलकोष्टक
मलपू->मलपु
मालव->मलव
माला->मला
मालाकर->मलाकार
मालाकार->मलाकार
मालावन्त्->मलावन्त्
मालित->मलित
मालिन्य->मलिन्य
मालोपमा->मलोपमा
मसन->मशन
मासन->मशन
मसक->मशाक
मासक->मशाक
मसि->मशि
मसि->मशी
माषि->मषी
मास->मस
मासुरी->मसूरि
मासुरी->मसूरी
महाद्भुत->महद्भूत
महान्तक->महन्तक
महावराह->महवराह
महावाराह->महवराह
महासेन->महसेन
महाकारण->महाकरण
महाकरुणाचन्द्रि->महाकरुणचन्द्रि
महाकर्कारु->महाकर्करु
महाघोष->महागोष
महागौरी->महागौरि
महाचित्रपाटल->महाचित्रपटल
महाधनपति->महादानपति
माहन->महान
महानारायणोपनिषद्->महानारयणोपनिषद्
महानील->महानिल
महापार->महापण
महापात्र->महापत्र
महाफणक->महापराक
महाप्रतीहार->महाप्रतिहार
महाभार->महाभर
महामञ्जूषक->महामञ्जुषक
महामाया->महामया
महामेधा->महामेदा
माहाव्रती->महाव्रती
महाशङ्ख->महाशङ्क
महासुर->महाशूर
महासांघिक->महासंघिक
महीपति->महिपति
माहिष्मती->महिष्मति
माहिष्मती->महिष्मती
महीयै->महीये
माहेन्द्रवाणी->महेन्द्रवाणी
महोत्साह->महोत्सह
मांसपेशी->मांसपेशि
मांसौदन->मांसोदन
माक्षीकशर्करा->माक्षिकशर्करा
माक्षीकशर्करा->माक्षिकाशर्करा
माञ्जिष्ठ->माञ्जिष्ट
माञ्जिष्ठिक->माञ्जिष्टिक
माठी->माटि
मारि->माणि
माण्डूक->माण्डुक
माण्डूकि->माण्डुकि
माण्डूकेय->माण्डुकेय
माधुक->मादुक
माधूक->मादुक
माद्री->माद्रि
माधवाचार्य->माधवाचर्य
मानायन->मानयान
मान्थ्य->मान्त्य
मारारि->मारणी
मार्जालीय->मार्जलीय
मालाका->मालका
मालकौश->मालकोश
मालाकण्ठ->मालाकण्ट
मासुरी->मासुरि
मिच्छक->मिच्चक
मीलिका->मिलिका
मीलित->मिलित
मीव्->मिव्
मिशर->मिशण
मिसर->मिशण
मिसि->मिशी
मिसरूमिश्र->मिसरुमिश्र
मुह्->मुः
मुख->मुक
मूक->मुक
मुखुली->मुकुली
मुकुष्ठक->मुकुष्टक
मुक्तापुष्प->मुक्तपुष्प
मुक्ताप्रालम्ब->मुक्ताप्रलम्ब
मुक्तावली->मुक्तावलि
मुञ्जातक->मुञ्जताक
मूढ->मुड
मुर->मुण
मूर->मुण
मूतिब->मुतिब
मूत->मुथ
मुराद->मुरद
मूर्छा->मुर्छा
मूल->मुल
मुसल->मुशल
मुसल्य->मुशल्य
मुष्कभार->मुष्कभर
मुष्कशून्य->मुष्कशुन्य
मुष्टीमुष्टि->मुष्टिमुष्टि
मुहुस्->मुहुश्
मृगजीवन->मृगजिवन
मृगार->मृगण
मृगलाञ्छन->मृगलाञ्चन
मृगी->मृगि
मृणालवन्त्->मृणलवन्त्
मृत्कांस्य->मृत्कांश्य
मृध->मृद
मेघराजी->मेघराजि
मेठ->मेट
मेठि->मेटि
मेठि->मेटी
मेढ्र->मेड्र
मेढी->मेढि
मैत्रावरुण->मेत्रावरुण
मेधाकृत्->मेदकृत्
मेदस्->मेदश्
मेधस्->मेदश्
मेधा->मेदा
मेधस->मेदाश
मेधि->मेदी
मेधाजित्->मेधजित्
मेधाकार->मेधाकर
मेनाजा->मेनजा
मेषविषाणिका->मेषविषणिका
मैत्रीनाथ->मैत्रिनाथ
मैत्रीभाव->मैत्रिभाव
मौक्य->मोक्य
मौख्य->मोक्य
मौदक->मोदाक
मोराक->मोरक
म्रदिष्ठ->म्रदिष्ट
यछ्->यच्
याच्->यच्
याज्यता->यज्ञता
यज्ञवल्ली->यज्ञवल्लि
यज्ञवाह->यज्ञवह
याज्ञसेनि->यज्ञसेनि
यातन->यतन
यातन->यतान
यथाहार->यताहार
यतिथ->यतित
याति->यती
यात्रा->यत्रा
यात->यथ
याथ->यथ
याथाकथाच->यथाकथाच
याथाकामी->यथाकामी
यथाख्यात->यथाख्यत
यथाप्रधानम्->यथाप्रदानम्
यथोपपादम्->यथोपपदम्
यादृच्छिक->यदृच्छिक
याभ->यभ
यमदैवत->यमदेवत
यामिका->यमिका
यामिनी->यमिनी
यामि->यमी
यामी->यमी
याम्या->यम्या
ययाति->ययति
यायातिक->ययातिक
यायिन्->ययिन्
यवक्री->यवक्रि
यविष्ठ->यविष्ट
यशस्->यशश्
यशोमती->यशोमति
यास->यस
याशु->यसु
याच्छ्रेष्ठ->याच्छ्रेष्ट
याजुर्वैदिक->याजुर्वेदिक
यात्राकार->यात्राकर
यायावर->यायवर
याष्टीक->याष्टिक
यून्->युङ्
युध्->युद्
युद्ध->युद्द
यूप->युप
यूष->युष
योगमुक्तावली->योगमुक्तावलि
यौगिक->योगिक
यौन->योन
रक्तवरटी->रक्तवरटि
रक्तस्राव->रक्तश्रव
रक्तस्राव->रक्तश्राव
रक्षोवाह->रक्षोवह
रजनीजल->रजनिजल
रजनीपति->रजनिपति
रजनीमुख->रजनिमुख
रजाशय->रजसय
रतू->रतु
रत्नावती->रत्नवती
रत्नावली->रत्नावलि
रथपाद->रथपद
रथसप्तमी->रथसप्तमि
रथी->रथि
राति->रथि
राधि->रदि
राधि->रदी
राद्ध->रद्ध
राध->रध
रान्धस->रन्धस
रभ्->रब्
रभ->रब
रभि->रबि
रामणि->रमणी
रामल->रमल
रामण->रमाण
रामोद->रमोद
राम्या->रम्या
रयिषाच्->रयिषच्
रयिषाह्->रयिषह्
रर्फ्->रर्प्
रवथ->रवत
रावण->रवाण
रस्->रश्
राश्->रश्
रास्->रश्
रस->रश
रास->रश
रसन->रशन
रासन->रशन
रस्य->रश्य
रास्य->रश्य
रास्ना->रस्ना
राजादन->राजदन
राजादन->राजधन
राजादन->राजधान
राजानक->राजनक
राजमण्डूक->राजमण्डुक
राजावर्त->राजवर्त
राजवाहन->राजवहन
राजवीथी->राजविथी
राजासन->राजशन
राजसुख->राजशुक
रारा->राणा
राथीतर->राथितर
रायान->रायन
रास->राश
राहुग्राह->राहुग्रह
रिक्थहर->रिक्तहार
रिक्थहार->रिक्तहार
रिक्थाद->रिक्ताद
रीव्->रिव्
रीर->रीण
रुह्->रुः
रुचिराञ्जन->रुचिरञ्जन
रुथ->रुत
रुध->रुद
रुधिरामय->रुधिरमय
रूप->रुप
रूपक->रुपक
रूपगोस्वामिन्->रुपगोस्वामिन्
रूप्यक->रुप्यक
रूपकताल->रूपकतल
रैणव->रेणव
रेणुरूषित->रेणुरुषित
रेभ्->रेब्
रेभ->रेब
रैभ->रेब
रैभ्य->रेभ्य
रौट्->रोट्
रोमकेसर->रोमकेशर
रोमन्थाय्->रोमन्थय्
रोमविध्वंस->रोमविध्वंश
रौमहर्षणक->रोमहर्षणक
रोमावली->रोमावलि
रौण->रोर
रोहिताश्व->रोहितश्व
रौमशीय->रौमशिय
लाक्षा->लक्षा
लक्ष्मीनृसिंह->लक्ष्मिनृसिंह
लक्ष्मीफल->लक्ष्मीपल
लाघ्->लघ्
लघिष्ठ->लघिष्ट
लघूकरण->लघुकरण
लङ्घन->लङ्गन
लाङ्गलि->लङ्गली
लाज->लज
लाजि->लजि
लाजी->लजि
लाजि->लजी
लाजी->लजी
लाड->लड
लाडि->लडि
लाप->लप
लभ्->लब्
लाभ्->लब्
लम्भ्->लंब्
लम्भ->लंब
लम्बोष्ठ->लम्बोष्ट
लाल->लल
लालक->ललाक
लालाटिक->ललाटिक
लालाटि->ललाटी
लालाटी->ललाटी
ललीतिका->ललितिका
लालित->ललिथ
लवणखानि->लवणखनि
लवली->लवलि
लावानक->लवानक
लस->लश
लास->लश
लस्पूजनी->लस्पूजनि
लाटानुप्रास->लाटानुप्राश
लावाणक->लावणक
लिह्->लिः
लिम्पाक->लिम्पक
लीला->लिला
लीलाकमल->लिलाकमल
लीलागार->लिलागार
लीलाय्->लिलाय्
लीलावापी->लिलावापी
लू->लु
लुण्ठन->लुण्टन
लूता->लुता
लुभ्->लुब्
लुम्बिनी->लुम्बिनि
लूष->लुष
लूह->लुह
लेखाभ्रू->लेखाभ्रु
लेलाय्->लेलय्
लोकचारित्र->लोकचरित्र
लोचनामय->लोचनमय
लोभायन->लोभयान
लोहाकर्ण->लोहकर्ण
लौहकारि->लोहकारी
लौहचारक->लोहचारक
लौहमल->लोहमल
लौहशास्त्र->लोहशास्त्र
लौहाचार्य->लोहाचार्य
लौहितीक->लोहितीक
लौहि->लोही
लौहितीक->लौहितिक
वंसग->वंशग
वंशधारा->वंशधरा
वह्->वः
वाक->वक
वक्रपाद->वक्रपद
वक्षस्->वक्षश्
वक्षी->वक्षि
वाक->वख
वागु->वगु
वाङ्क->वङ्क
वाङ्गक->वङ्गक
वाचक->वचक
वाचा->वचा
वच्छल->वच्चल
वाज->वज
वाजसनेयक->वजसनेयक
वज्राकर->वज्रकण
वज्रवाराही->वज्रवराही
वाञ्छित->वञ्चित
वाटु->वटु
वटूरिन्->वटुरिन्
वाट्टक->वट्टक
वाट->वठ
वडभी->वडभि
वरिन्->वणिङ्
वारिन्->वणिङ्
वात->वत
वतू->वतु
वत्सप्री->वत्सप्रि
वात्सप्रीय->वत्सप्रीय
वात्सीपुत्रीय->वत्सीपुत्रीय
वादनक->वदनक
वाधुल->वदुल
वाधूल->वदुल
वादवाद->वधावध
वादिर->वधिर
वादि->वधी
वध्रस्व->वध्रश्व
वनकार्पासी->वनकार्पसि
वनकार्पासी->वनकार्पसी
वनकार्पासी->वनकार्पासि
वनपांसुल->वनपांशुल
वानराष्टक->वनराष्टक
वानवासिक->वनवासिक
वानवासी->वनवासी
वाना->वना
वनीक->वनिक
वानिक->वनिक
वानीय->वनीय
वाङ्ग->वन्ग
वान्या->वन्या
वापनि->वपनी
वापक->वपाक
वापीह->वपीह
वामक->वमक
वामनी->वमनी
वाम्य->वम्य
वायक->वयाक
वायोधस->वयोधस
वरणस्रज्->वरणश्रज्
वाणरसी->वरणाशी
वाणारसी->वरणाशी
वाराणसी->वरणाशी
वारत्र->वरत्र
वरादन->वरधान
वारधान->वरधान
वारनारी->वरनारी
वरपर्णाख्य->वरपर्णख्य
वरमुखी->वरमुकी
वारयुवति->वरयुवती
वारयोषित्->वरयोषित्
वराण->वरर
वारण->वरर
वारला->वरला
वरालि->वरली
वारवारण->वरवरण
वारवारण->वरवारण
वराडी->वराडि
वाणरसी->वराणसी
वाणारसी->वराणसी
वाराणसी->वराणसी
वारलक->वरालक
वारला->वराला
वाराहकर्णी->वराहकर्णी
वाराहपत्त्री->वराहपत्त्री
वरी->वरि
वाणि->वरि
वाणी->वरि
वारि->वरि
वारी->वरि
वरीदास->वरिदास
वरुणग्राह->वरुणग्रह
वारुणप्रघासिक->वरुणप्रघासिक
वर्णपात्र->वर्णपत्र
वार्त्त->वर्त्त
वार्त्ताक->वर्त्तक
वार्त्तिक->वर्त्तिक
वार्द्ध->वर्द्ध
वार्द्धक->वर्द्धक
वार्धनी->वर्धनी
वर्माय्->वर्मय्
वार्वट->वर्वट
वार्वर->वर्वर
वर्वूर->वर्वुर
वार्षगण->वर्षगण
वार्षपर्वणी->वर्षपर्वणि
वार्षसहस्रिक->वर्षसहस्रिक
वालधि->वलदी
वलम्भ->वलम्ब
वलम्भ->वलंब
वालक->वलाक
वालन->वलान
वल्गुली->वल्गुलि
वल्मी->वल्मि
वाल्मीकभौम->वल्मीकभौम
वाव->वव
वसिष्ठ->वशिष्ठ
वसतीवरी->वसतिवरी
वसाति->वसती
वसतीवरी->वसतीवरि
वसावि->वसवि
वसुधार->वसुधर
वसुरात->वसुरथ
वस्तूकी->वस्तुकी
वागुजी->वागुजि
वागुरि->वागुणि
वाग्याम->वाग्यम
वाग्वाद->वाग्वद
वाचाल->वाचल
वाजप्रसूत->वाजप्रसुत
वाटीदीर्घ->वाटिदीर्घ
वारबाण->वाणबार
वारवन्त्->वाणवन्त्
वारणी->वाणारि
वारासन->वाणासन
वारिन्->वाणिन्
वारिनाथ->वाणीनाथ
वाताय->वातय
वातायन->वातयान
वाद्यभाण्ड->वाद्यभण्ड
वाराणसी->वारणसी
वाराणसी->वारणासी
वार्त्तायन->वार्त्तयन
वालावितु->वालवितु
वास्रा->वाश्रा
वाहूक->वाहुक
विकार्य->विकर्य
विकासन->विकाशन
विकासिता->विकाशिता
विख्र->विक्र
विक्रीड->विक्रिड
विक्षर->विक्षण
विक्षार->विक्षण
विक्षीर->विक्षीण
विगाथा->विगता
विङ्ख->विङ्क
विचारित->विचरित
विजानि->विजनी
विजयादशमी->विजयदशमी
विज्जाका->विज्जका
विज्जूलिका->विज्जुलिका
विञ्जामर->विञ्जमर
वितर्द्धि->वितर्द्दी
वितस्तापुरी->वितस्तपुरी
विधस्->विदस्
विधस्->विदाश्
विधूप->विदुप
विधुरता->विदूरता
विधूरता->विदूरता
विधेय->विदेय
विद्रावण->विद्रवण
विधूत->विधुत
विनासादशन->विनासदशन
विफ->विप
विपस्->विपश्
विपाश्->विपश्
विपाशिन्->विपशिन्
विपासा->विपाशा
विपुलास्रवा->विपुलस्रवा
विपुलास्रवा->विपुलाश्रवा
विबाध->विबध
विभ्रु->विब्रू
विभाजन->विभजन
विभाविन्->विभविन्
विमध्य->विमद्य
विमान->विमन
विमही->विमहि
विमृध्->विमृद्
वियात->वियत
विराजन->विरजन
विराट->विरट
विराध->विरद
विरूक्ष->विरुक्ष
विरूक्षण->विरुक्षण
विरूढ->विरुढ
विरूप->विरुप
विरूपक->विरुपक
विरूपय्->विरुपय्
विरूपाक्ष->विरुपाक्ष
विलास->विलस
विवाच्->विवच्
विविध->विविद
विशाल->विशल
विशालीय->विशालिय
विशीत->विशित
विशिष्टी->विशिष्टि
विशून्य->विशुन्य
विशृङ्खल->विशृङ्कल
विश्वतस्->विश्वतश्
विश्वान्तर->विश्वन्तर
विश्वरूप->विश्वरुप
विश्वावसु->विश्ववसु
विश्वशंभू->विश्वशम्भु
विश्वासन->विश्वसन
विश्वस्था->विश्वस्ता
विश्वास्य->विश्वस्य
विश्वाहा->विश्वहा
विश्वाची->विश्वाचि
विश्वासह्->विश्वासः
विषाण->विषण
विषार->विषण
विषाद्->विषद्
विषयाज्ञान->विषयज्ञान
विषारि->विषाणी
विषूचि->विषुचि
विषूची->विषुचि
विषौषधी->विषोषधी
विष्कन्ध->विष्कन्द
विष्ठल->विष्टल
विष्ठाभू->विष्टाभू
विष्णापू->विष्णापु
विष्णुदैवत्य->विष्णुदेवत्य
विष्वाच्->विष्वच्
विस्तारण->विस्तरण
विस्फूर्जथु->विस्फुर्जथु
विहार->विहाण
विहेठक->विहेटक
वीखा->वीका
वीरनारायण->वीरनारयण
वृत्तरत्नावली->वृत्तरत्नावलि
वृषाकपायी->वृषकपायी
वृषामोदिनी->वृषमोदिनी
वृषी->वृषि
वै->वे
वैकटिक->वेकटिक
वैङ्गि->वेङ्गि
वैङ्गि->वेङ्गी
वेढमिका->वेडमिका
वेणीस्कन्ध->वेणिस्कन्ध
वेणीस्कन्ध->वेणीस्कन्द
वैतालीय->वेतालीय
वैत्रकीयवन->वेत्रकीयवन
वेत्रावती->वेत्रवती
वेदगाथ->वेदगत
वेधमुख्य->वेदमुख्य
वेदायन->वेदयान
वैदायन->वेदयान
वेदाध्यायिन्->वेदाध्ययिन्
वेधित->वेदित
वैदि->वेदी
वैदिक->वेदीक
वैद्युत->वेद्युत
वैदि->वेधी
वैदुर्य->वेधुर्य
वैदूर्य->वेधुर्य
वैधुर्य->वेधुर्य
वैराम->वेरम
वैरि->वेरि
वेलाय्->वेलय्
वेलाकूल->वेलाकुल
वेस्->वेश्
वेशीजाता->वेशिजाता
वैश्यत्व->वेश्यात्व
वैरि->वैणि
वैतथ्य->वैतत्य
वैयाघ्र->वैयग्र
वैरागिक->वैरगिक
वैशालि->वैशली
वोढर्->वोडर्
वोरपट्टी->वोरपट्टि
वोल्लाह->वोल्लह
व्यंसक->व्यंशक
व्याङ्गि->व्यङ्गी
व्यथ्->व्यत्
व्यथि->व्यती
व्यथित->व्यतीत
व्यथ्ययः->व्यत्ययः
व्यध्->व्यद्
व्यध्य->व्यद्य
व्याध्य->व्यद्य
व्याधित->व्यधित
व्यवधा->व्यवदा
व्यस्->व्यश्
व्याधित->व्यादित
व्यापाद->व्यापद
व्यापीत->व्यापित
व्योमपाद->व्योमपद
व्राजपति->व्रजपति
व्रातीन->व्रतीन
व्रैह->व्रेह
शांशप->शंसप
शाकटीकर्ण->शकटीकर्ण
शाकरी->शकरि
शाकारी->शकरि
शाका->शका
शाकनिका->शकानिका
शाकरी->शकारि
शाकारी->शकारि
शाकी->शकि
शाखि->शकि
शाकिन->शकिन
शाकुन्तल->शकुन्तल
शाकुण->शकुर
शाकोट->शकोट
शाखोट->शकोट
शङ्खण->शङ्कर
शाङ्कर->शङ्कर
शांकरि->शंकरी
शङ्खोद्धार->शङ्कोद्धार
शांकर->शंखण
शाङ्खलिखित->शङ्खलिखित
शठाम्बा->शठम्बा
शाठी->शठी
शाड्->शड्
शारिका->शणिका
शतखण्ड->शतकाण्ड
शातकौम्भमय->शतकौम्भमय
शतघ्नी->शतघ्नि
शतधा->शतदा
शतधाय->शतदाय
शातन->शतन
शतपादी->शतपदी
शतायुध->शतयुध
शतायुध->शतयूध
शत्रुतापन->शत्रुतपन
शत्रूषह्->शत्रुषह्
शत्रुसाह->शत्रुसह
शान->शन
शनैस्->शनैश्
शाबरि->शबरी
शब्दरत्नावली->शब्दरत्नावलि
शब्दसाह->शब्दसह
शामम्->शमम्
शामा->शमा
शामिक->शमीक
शामूल->शमूल
शम्पाताल->शम्पातल
शम्भ->शंब
शाम्बर->शंबर
शांभर->शंबर
शंभुवर्धन->शम्बुवर्धन
शंभु->शम्बू
शंभू->शम्बू
शाम्बर->शम्भर
शांभर->शम्भर
शांभव->शम्भव
शंभू->शम्भु
शंभूनाथ->शम्भुनाथ
शयनैकादशी->शयनैकदशी
शायिन्->शयिन्
शराघात->शरघात
शरारि->शरणी
शारदातिलक->शरदातिलक
शरव्याय्->शरव्यय्
शार्क->शर्क
शार्करीधान->शर्करीधान
शार्ग->शर्घ
शर्ध->शर्द
शर्वाणी->शर्वणी
शर्वाणी->शर्वरी
शालन->शलङ
शालङ्क->शलङ्क
शालि->शली
शाली->शली
शालु->शलु
शाल्मलि->शल्मली
शावक->शवक
शवर->शवण
शावर->शवण
शवाश->शवस
शाश्वत्->शश्वत्
शष्कुली->शष्कुलि
शस्तोक्थ->शस्तोक्त
शास्त्रकार->शस्त्रकार
शास्त्रवत्->शस्त्रवत्
शास्त्रित->शस्त्रित
शाकटायन->शाकटयन
शाकपूणि->शाकपुणि
शाकायन्य->शाकयन्य
शाङ्ख->शाङ्क
शाङ्खिक->शाङ्किक
शाठी->शाटि
शाठी->शाटी
शारि->शाणी
शांभव->शाम्बव
शारदण्डायनी->शारदण्डायनि
शारदातिलक->शारदतिलक
शार्दूल->शार्दुल
शालीन->शालिन
शालीय->शालिय
शालूर->शालुर
शीक्->शिक्
शिखरिन्->शिकरिन्
शीकरिन्->शिकरिन्
शिक्षाकार->शिक्षाकर
शीक्->शिख्
शिखरी->शिखरि
शिखिकण्ठ->शिखिकण्ट
शिखियूप->शिखियुप
शीघ्रबोध->शिघ्रबोध
शीघ्र्य->शिघ्र्य
शिमीवन्त्->शिमिवन्त्
शिरस्->शिरश्
शिरोघात->शिरोगत
शिलाज->शिलज
शिलावह->शिलवह
शिलींध्र->शिलिंध्र
शिलींध्रक->शिलिंध्रक
शिल्पकार->शिल्पकर
शिवकारिणी->शिवकरिणि
शिवचतुर्दशी->शिवचतुर्दशि
शिवादेशक->शिवदेशक
शिवापर->शिवपर
शिशूल->शिशुल
शीतपर्णी->शीतपर्णि
शुकफल->शुकपाल
शूकपिण्डि->शुकपिण्डी
शूकशिम्बि->शुकशिम्बि
शूकशिम्बि->शुकशिम्बी
शूकृत->शुकृत
शूर्->शुण्
शुर->शुण
शूर->शुण
शुण्ठ->शुण्ट
शुण्ठि->शुण्टि
शुनासीर->शुनाशीर
शुनी->शुनि
शुभ्र->शुब्र
शुभाय्->शुभय्
शूर्->शुर्
शूरपुत्रा->शुरपुत्रा
शूर्प->शुर्प
शुश्रूषक->शुश्रुषक
शूकार->शूकर
शूकापूट्ट->शूकापुट्ट
शून्याशून्य->शून्यशून्य
शूलकार->शूलकर
शृङ्घाणिका->शृङ्गारिका
शृङ्गीकनक->शृङ्गिकनक
शैख->शेक
शैखरिक->शेखरिक
शैबल->शेबल
शैल->शेल
शैव्य->शेव्य
शेषभूत->शेषभुत
शौचक->शोचक
शोणमणी->शोणमणि
शौरि->शोणी
शौण्डि->शोण्डी
शौन->शोन
शोली->शोलि
शौण्डीर->शौण्डिर
शौर्यौदार्यशृङ्गारमय->शौर्यौदर्यशृङ्गारमय
श्माशानिक->श्मशानिक
श्यावाश्व->श्यवाश्व
श्राण->श्रण
श्रद्धान->श्रद्दान
श्राद्ध->श्रद्ध
श्राद्धीय->श्रद्धीय
श्रापय्->श्रपय्
श्रावणविधि->श्रवणविधि
श्रीपति->श्रिपति
श्रीय->श्रिय
श्रीवृक्षक->श्रिवृक्षक
श्रीश->श्रिश
श्रीहर्ष->श्रिहर्ष
श्रुतश्रोणी->श्रुतश्रोणि
श्रेडी->श्रेडि
श्रेणीभूत->श्रेणिभूत
श्रेयांस->श्रेयांश
श्रेष्ठ->श्रेष्ट
श्रोथ->श्रोत
श्रौत->श्रोत
श्रौषट्->श्रोषट्
श्रौष्टि->श्रोष्टि
श्लाख्->श्लक्
श्लख->श्लक
श्लाघ्->श्लग्
श्लैष्मिक->श्लेष्मिक
श्वपाक->श्वपक
श्वाशुरि->श्वशुरी
श्वास->श्वस
श्वाविध्->श्वाविद्
श्वेतरथ->श्वेतरत
श्वेतवाह्->श्वेतवह्
श्वेतवाह्->श्वेतवाः
श्वेतानूकाश->श्वेतानुकाश
श्वैति->श्वेती
श्वैत्रेय->श्वेत्रेय
षाट्->षट्
षाड्वर्गिक->षड्वर्गिक
षाड्वर्गिक->षड्वार्गिक
षण्ढतिल->षण्डतिल
षण्ढय्->षण्डय्
षष्ठिका->षष्टिका
षष्ठीप्रिय->षष्टीप्रिय
षाष्ठिक->षाष्टीक
षुरासाण->षुराशाण
षोढा->षोडा
ष्ठु->ष्टु
ष्ठीव->ष्ठिव
ष्ठ्यूत->ष्ठ्युत
संयती->संयति
संयाति->संयति
संयान->संयन
संयुयूषु->संयुयुषु
संवाच्->संवच्
संवार्य->संवर्य
संवास->संवस
संविधा->संविदा
संविधान->संविदान
संसद्->संशद्
संसव->संशव
संसाद->संसद
संसादन->संसदन
संसाधन->संसदन
संहात्य->संहत्य
सकार->सकण
सकार->सकर
सकारणक->सकरणक
सकारविपुला->सकरविपुला
सकाली->सकली
सखिल->सकील
सघ->सग
संघट->संगट
संघाट->संगट
संघतल->संगतल
संगृहीत->संगृहित
संघाटी->संघाटि
संज्वारिन्->संज्वरिन्
सटाङ्क->सटङ्क
सतार->सतर
सतीय->सतिय
सत्पात्र->सत्पत्र
सत्यवाच्->सत्यवच्
सत्यावन्->सत्यवान्
सत्रासाह->सत्रासह
सधनी->सदनि
सधि->सदि
सधिस्->सदिश्
सद्यस्->सद्यश्
सध्रि->सद्रि
सध्री->सद्रि
सधमाद्->सधमद्
सधर्मचारिणी->सधर्मचारिणि
सनाथ->सनत
संतान->संतन
संतानिक->संतनिक
संधा->संदा
संधित->संदित
संधि->संदी
संद्राव->संद्रव
संधानीय->संधनीय
संधाय->संधय
संधिचौर->संधिचोर
संध्याभ्र->संध्यभ्र
संन्यासविधि->संन्यसविधि
सपर->सपण
सपत्नी->सपत्नि
सप्तस्रोतस्->सप्तश्रोतस्
सप्तोत्साद->सप्तोत्सद
समाकर->समकर
समाकार->समकर
समागति->समगति
समाति->समती
समादेश->समदेश
समाधा->समधा
समाधि->समधी
समाधित->समधीत
समाम->समम
समायिन्->समयिन्
समाली->समली
समवसरण->समवशरण
समावृत्ति->समवृत्ति
समस्->समश्
समष्ठीला->समष्ठिला
समाचार->समाचर
समाधा->समादा
समालम्भन->समालम्बन
समालम्भिन्->समालंबिन्
समाश्वास्य->समाश्वस्य
सामि->समी
सामीची->समीची
सामुद्रि->समुद्रि
समुद्वाह->समुद्वह
समुपानयन->समुपनयन
सांघात->सम्गत
सांगम->सम्गम
संपाति->सम्पति
संपाद->सम्पद
सांपद->सम्पद
संपादिन्->सम्पदिन्
संपार->सम्पर
सांपराय->सम्पराय
सांपरायिक->सम्परायिक
संपावन->सम्पवन
संपाठ->सम्पाट
सांपद->सम्पाद
संप्रैष->सम्प्रेष
संफाल->सम्फल
संबाधन->संबधन
संभर->सम्बर
संभार->सम्बर
संभार्य->सम्बर्य
संभल->सम्बल
संभूत->सम्बूत
संभूति->सम्बूति
संभार->सम्भर
संभाव->सम्भव
संभावन->सम्भवन
संभाविन्->सम्भविन्
संभाव्य->सम्भव्य
संमाद->सम्मद
संमील्य->सम्मिल्य
सांयमनि->सम्यमनी
सांयाति->सम्याति
सांवत्सर->सम्वत्सर
सांवरण->सम्वरण
सांवर्त->सम्वर्त
सांवर्तक->सम्वर्तक
सांहार->सम्हार
सरथ->सरत
सरलाय्->सरलय्
सरसी->सरसि
सरसीरुह->सरसिरुह
सरस्वतीतीर्थ->सरस्वतितीर्थ
सर्पसत्त्र->सर्पशत्त्र
सर्वतस्->सर्वतश्
सर्वथा->सर्वता
सर्वाधार->सर्वधार
सर्वाणी->सर्वरी
सर्वावन्त्->सर्ववन्त्
सर्वावास->सर्ववास
सर्वावासिन्->सर्ववासिन्
सवात्य->सवत्य
सवित्री->सवित्रि
सस्रि->सश्री
सस्यशूक->सस्यशुक
सहपत्नी->सहपत्नि
सहपांसुकिल->सहपांशुकिल
सहाय->सहय
सहस्रसाव->सहस्रसव
सहस्रहर्याश्व->सहस्रहर्यश्व
सहार्ध->सहार्द
सहैकस्थान->सहैकस्थन
सांस->सांश
सांसारिक->सांसरिक
सांस्राविण->सांस्रविण
सागरनेमी->सागरनेमि
सांक्रामिक->सांक्रमिक
सातीन->सातिन
सात्रासाह->सात्रासह
साधक->सादक
सानाथ्य->सानथ्य
सामात्य->सामत्य
सामान्याभाव->सामान्यभाव
सामुदायिक->सामुदयिक
सारघ->सारग
सारमेयादन->सारमेयदन
सारसन->सारशन
सारावली->सारावलि
सारिष्ठ->सारिष्ट
सारूप्य->सारुप्य
सार्वरौगिक->सार्वरोगिक
साहायक->साहयक
सिंहकेसर->सिंहकेशर
सीक्->सिक्
सिक्थक->सिक्तक
सिङ्घाण->सिङ्घण
सिताखण्ड->सितखण्ड
सीता->सिता
सिन्धुराव->सिन्धुरव
सीमिक->सिमीक
सीमीक->सिमीक
सीर->सिर
सीवक->सिवक
सीस->सिस
सीसक->सिसक
सीलन्ध->सीलन्द
सुख->सुक
सूक->सुक
सुखमद->सुकामद
सुकूर्कुर->सुकुर्कुर
सूक्ति->सुक्ति
सुखार्थ->सुखार्त
सुखी->सुखि
सुचारा->सुचरा
सुचीरा->सुचिरा
सूतक->सुतक
सूतता->सुतता
सूतपुत्र->सुतापुत्र
सुतीर्थ->सुतिर्थ
सूद्->सुद्
सूद->सुद
सुदाम->सुदम
सुदास्->सुदस्
सुधातर्->सुदातर्
सुधि->सुदि
सुधी->सुदि
सूद्य->सुद्य
सुधाय->सुधय
सूदकर्मन्->सुधाकर्मन्
सुधाधार->सुधाधर
सुधास्रवा->सुधाश्रवा
सून->सुन
सुनाथ->सुनत
सुनासीर->सुनाशीर
सुनीत->सुनित
सुनीथ->सुनित
सूनु->सुनू
सुपात्र->सुपत्र
सुप्तोत्थित->सुप्तोत्तिथ
सुप्रतीक->सुप्रतिक
सुप्रतिष्ठ->सुप्रतिष्ट
सुप्रतिष्ठित->सुप्रतिष्टित
सुप्रावी->सुप्रावि
सुभ्->सुब्
सुभाञ्जन->सुभञ्जन
सुमज्जानि->सुमज्जनि
सुमनास्य->सुमनस्य
सुराति->सुरति
सुराधर->सुरदार
सुराधिप->सुरधिप
सूरवर्मन्->सुरवर्मन्
सूरसेन->सुरसेन
सूरि->सुरी
सूरी->सुरी
सूर्य->सुर्य
सूर्यवंश->सुर्यवंश
सूर्यवर->सुर्यवार
सूर्यवार->सुर्यवार
सुवास->सुवश
सुवीरज->सुविरज
सुसस्य->सुशास्य
सूष्->सुष्
सुषीम->सुषिम
सुहू->सुहु
सूखर->सूकार
सूचीखात->सूचिखात
सूचीपत्त्र->सूचिपत्त्र
सूचीमुख->सूचिमुख
सूरसूत->सूरसुत
सूर्मी->सूर्मि
सूर्याचन्द्रमसा->सूर्यचन्द्रमसा
सूर्यासूक्त->सूर्यसूक्त
सृगालजम्बू->सृगालजम्बु
सेनानी->सेनानि
सैरि->सेरि
सैस->सेश
सैनानीक->सैनानिक
सैन्धवायन->सैन्धवयान
सौक्ति->सोक्ति
सौख->सोख
सौडल->सोढल
सोपादान->सोपधान
सोपाधि->सोपधि
सौभरि->सोभरी
सौभाञ्जन->सोभाञ्जन
सोमपात्र->सोमपत्र
सोमपीथ->सोमपिथ
सोमरात->सोमरथ
सोमारौद्र->सोमरौद्र
सौमारौद्र->सोमरौद्र
सोमाल->सोमल
सोमावती->सोमवती
सोमवल्लरी->सोमवल्लरि
सोमहूति->सोमहुति
सोमाहुति->सोमहुति
सौमायन->सोमायन
सौमी->सोमी
सौमेन्द्र->सोमैन्द्र
सौर->सोर
सौरण->सोरण
सौदामनी->सौदामनि
सौधकार->सौधकर
सौभाग्य->सौभग्य
सौमी->सौमि
सौराष्ट्र->सौरष्ट्र
सौष्ठव->सौष्टव
स्खद्->स्कद्
स्कन्धक->स्कन्दक
स्कन्धफल->स्कन्दपाल
स्कन्धाक्ष->स्कन्दाक्ष
स्कन्दापस्मार->स्कन्दापस्मर
स्कन्धिक->स्कन्दिक
स्कन्धवाह->स्कन्धवह
स्थ->स्त
स्थानत्याग->स्तनत्याग
स्थानिन्->स्तनिन्
स्तम्भकर->स्तम्बकार
स्ताम्भिन्->स्तंभिन्
स्तरी->स्तरि
स्थाणु->स्तरु
स्थावर->स्तवर
स्थवि->स्तवि
स्थग->स्ताघ
स्थाग->स्ताघ
स्तीम->स्तिम
स्तोमपृष्ठ->स्तोमपृष्ट
स्त्रीचौर->स्त्रीचोर
स्त्रीभाग->स्त्रीभग
स्थागल->स्थगल
स्थान->स्थन
स्थलपद्मिनी->स्थलपद्मिनि
स्थिराय्->स्थिरय्
स्थिरयौवन->स्थिरयोवन
स्थूणकर्ण->स्थुणाकर्ण
स्थूणाकर्ण->स्थुणाकर्ण
स्थूण->स्थुर
स्थूर->स्थुर
स्थूरि->स्थुरी
स्थूललक्ष->स्थुललक्ष
स्थूरिका->स्थूणिका
स्थूरि->स्थूणी
स्थूलाष्ठीव->स्थूलाष्टीव
स्थौलाष्ठीवि->स्थौलाष्टीवि
स्नीहिति->स्निहिति
स्नुह्->स्नुः
स्नुही->स्नुहि
स्पार्शन->स्पर्शान
स्फाटि->स्फटि
स्फाटि->स्फटी
स्फाल->स्फल
स्फूर्छ्->स्फुर्छ्
स्फूर्ज->स्फुर्ज
स्फूर्जक->स्फुर्जक
स्फूर्जथु->स्फुर्जथु
स्फ्याग्र->स्फ्यग्र
स्मद्रातिषाच्->स्मद्रातिषच्
स्मरारि->स्मरणी
स्याल->स्यल
स्रंस्->स्रंश्
स्राक्->स्रक्
स्रीव्->स्रिव्
स्रुह्->स्रुः
स्रौतोवह->स्रोतोवह
स्वाक्त->स्वक्त
स्वठ्->स्वट्
स्वाद->स्वद
स्वादन->स्वदान
स्वादर->स्वदार
स्वधावन्->स्वदावन्
स्वधित->स्वदित
स्वधीत->स्वदित
स्वादन->स्वधन
स्वानुरूप->स्वनुरूप
स्वापद->स्वपद
स्वयंभू->स्वयम्भु
स्वायंभुव->स्वयम्भुव
स्वारुह्->स्वरुः
स्वारुह्->स्वरुह्
स्वारूपा->स्वरूपा
स्वर्णपाठक->स्वर्णपाटक
स्वर्थ->स्वर्त
स्वार्थ->स्वर्त
स्वल्पकेसरिन्->स्वल्पकेशरिन्
स्वावेश->स्ववेश
स्वास्->स्वश्
स्वास्->स्वस्
स्वाशु->स्वसू
स्वस्तिवाचन->स्वस्तिवचन
स्वास्थ्य->स्वस्त्य
स्वाजीव->स्वाजिव
स्वादिष्ठ->स्वादिष्ट
स्वानुभाव->स्वानुभव
स्वीकार->स्वीकर
स्वूर्छ्->स्वुर्छ्
स्वैरता->स्वेरता
स्वौपश->स्वोपश
हंसतूल->हंसतुल
हंसावती->हंसवती
हठपर्णी->हटपर्णी
हर->हण
हनूमन्तेश्वर->हनुमन्तेश्वर
हनूष->हनुष
हम्भा->हंबा
हयवाहनसंकर->हयवाहनशंकर
हारिकण्ठ->हरिकण्ठ
हरिराय->हरिणाय
हारीति->हरिती
हरिदास->हरिदाश
हरिद्रागणपति->हरिद्रगणपति
हारिन्->हरिन्
हरिश्रावा->हरिश्रवा
हारि->हरी
हार्य->हर्य
हालक->हलक
हलाहल->हलहल
हालहल->हलहल
हालहाल->हलहल
हालाहल->हलहल
हालिनी->हलिनी
हावनी->हवनी
हाविर्धानि->हविर्धानी
हाविष्कृत->हविष्कृत
हवै->हवे
हस्तताल->हस्ततल
हस्तिकाश्यप->हस्तिकश्यप
हस्तीन->हस्तिन
हास्तिन->हस्तिन
हस्तिनापुर->हस्तिनपुर
हास्तिनपुर->हस्तिनपुर
हास्य->हस्य
हारीति->हारिती
हालिनी->हालिनि
हिल्->हिL
हीक->हिक
हीड->हिड
हिण्डी->हिण्डि
हिमावती->हिमवती
हील->हीLअ
हीनकुष्ठ->हीनकुष्ट
हूंकृति->हुंकृति
हूण->हुण
हूत->हुत
हूण->हुर
हुरस्->हुरश्
हूष्कपुर->हुष्कपुर
हूहू->हुहू
हूहू->हूहु
हृदयग्राह->हृदयग्रह
हृदयाविध्->हृदयविध्
हृषी->हृषि
हेल्->हेL
हेलन->हेLअन
हेठ->हेट
हेतुरूपक->हेतुरुपक
हेमाभ->हेमभ
हैमवत->हेमवत
हैरम्ब->हेराम्ब
हेलञ्ची->हेलञ्चि
हेलाराज->हेलराज
हैलिहिल->हेलिहिल
हैहय->हेहय
हेहै->हेहे
होतुरन्तेवासिन्->होतुरन्तेवसिन्
होराशास्त्र->होरशास्त्र
ह्राद्->ह्रद्
ह्रास->ह्रस
ह्रिणीया->ह्रिणिया
ह्रूडु->ह्रुडू
ह्रूम्->ह्रुम्
ह्रौड्->ह्रोड्
