अपिजू->अपीजु
अपिजू->अपीजू
अरथि->अरथी
अर्द्धशफर->अर्द्धसफर
अवक्रम->अवक्राम
अवसे->अवसै
असम्भव्य->असंभाव्य
अस्तग->अस्ताग
अस्तग->अस्थाघ
आयस्य->आयास्य
आर्चभिन्->आर्चाभिन्
आर्त्नि->आर्त्नी
आर्द्द->आर्द्ध
उत्प्राशन->उत्प्रासन
उदर्द्द->उदर्द्ध
उर्द्द->ऊर्द्ध
ऊर्द्द->ऊर्द्ध
ऋतुपर्य्यय->ऋतुपर्य्याय
एकरम->एकाराम
एषावीर->ऐषावीर
कच्छुराक्षस->कच्छूराक्षस
कण्टकश्रेणि->कण्टकश्रेणी
कन्दगुडुची->कन्दगुडूची
करसुत्र->कारसूत्र
करामर्द्द->करामर्द्ध
करुणविप्रलम्भ->करुणाविप्रलम्भ
कर्करिका->कर्करीका
कर्द्दम->कार्द्दम
कलम्बु->कलम्बू
कवयि->कवयी
काञ्चिपद->काञ्चीपद
कान्तिनगरी->कान्तीनगरी
कामशक्ति->कामासक्ति
कालहर->कालहार
किर्म्मि->किर्म्मी
किर्म्मि->कीर्म्मी
कुलीक->कूलिक
कोलशिम्बि->कोलशिम्बी
क्षीरतेल->क्षीरतैल
खडतु->खडतू
खर्बुज->खर्बूज
खिङ्किर->खिङ्खिर
गर्मुच्छद->गर्मूच्छद
गोहरितकी->गोहरीतकी
चरण्टि->चरण्टी
चित्कण->चीत्कार
चुक्रवास्तुक->चुक्रवास्तूक
चुरि->चुरी
चुरि->चूरि
चुरि->चूरी
छगलण्ड->छगलाण्ड
छगलण्ड->छागलाण्ड
छगलाङ्घ्रि->छगलाङ्घ्री
छत्त्रधर->छत्त्रधार
जम्बुखण्ड->जम्बूखण्ड
जरणि->जारणी
जलबन्ध->जालबन्ध
जातिपत्री->जातीपत्री
जालवर्वुरक->जालवर्वूरक
ज्वरातिसार->ज्वरातीसार
ज्वालखरगद->ज्वालाखरगद
झणत्कर->झणत्कार
झिरि->झिरी
झृ->झॄ
तनूनपात->तानूनपात
तरुतुलिका->तरुतूलिका
तालङ्क->तालाङ्क
तासुन->तासून
तिणिश->तिणिस
तीर्थराजि->तीर्थराजी
तुम्बिपुष्प->तुम्बीपुष्प
तूलनालि->तूलनाली
तैलचोरिका->तैलचौरिका
तोयनिवी->तोयनीवी
त्र्युदय->त्र्युदाय
दनायु->दनायू
दिण्डिर->दिण्डीर
दुर्य्य->दूर्य्य
दुर्व->दूर्व
धरणिधृत्->धरणीधृत्
धरणीपुर->धरणीपूर
धवनि->धवनी
धवनि->धावनी
नकारः->नखरः
नक्षत्रवीथि->नक्षत्रवीथी
नवज्वर->नवज्वार
नीलि->नीली
पक्वशस्योपमोन्नति->पक्वसस्योपमोन्नति
पचप्रकुटा->पचप्रकूटा
पञ्चोदन->पञ्चौदन
पण्यवीथि->पण्यवीथी
परिधिपतिखेचर->परिधीपतिखेचर
परिपन->परिपान
परिपन->पारिपान
परेतवास->परेतावास
पव्य->पाव्य
पशुहरितकी->पशुहरीतकी
पांशुक्षार->पांसुक्षार
पांशुमर्दन->पांसुमर्दन
पार्श्वेकादशी->पार्श्वैकादशी
पाहत->पाहात
पित्तातिसार->पित्तातीसार
पिप्पलु->पिप्पलू
पुञ्जिल->पुञ्जील
पुत्रान्नद->पुत्रान्नाद
पुप्पुस->पुप्फुस
पुरुषांशक->पुरुषांसक
पूर्वशक्थ->पूर्वसक्थ
पैङ्गलोदायनि->पैङ्गलौदायनि
पैठिनसि->पैठीनसि
पौरुषांशकिन्->पौरुषांसकिन्
प्रतिपत्तुर्य्य->प्रतिपत्तूर्य्य
प्रतिसमन्त->प्रतिसामन्त
प्रतिहर->प्रतीहार
प्रतिहर->प्रातिहर
प्रतिहर->प्रातिहार
प्रियवद->प्रियवाद
प्रोढपाद->प्रौढपाद
प्रोढि->प्रौढि
प्रोण्ट->प्रोण्ठ
फञ्जि->फञ्जी
फणिचक्र->फणीचक्र
फलश->फलस
बृहत्समन्->बृहत्सामन्
ब्राह्मणयष्टि->ब्राह्मणयष्टी
भक्षालि->भक्षाली
भन्द्रुक->भन्ध्रुक
भारिट->भारीट
भूपाटलि->भूपाटली
मणिपालि->मणिपाली
मधुमल्लि->मधुमल्ली
मर्जु->मर्जू
मशि->मशी
मशि->मसि
मशि->मसी
महाशङ्क->महाशङ्ख
मांसपेशि->मांसपेशी
मालकोश->मालकौश
मालाकण्ट->मालाकण्ठ
मुष्कशुन्य->मुष्कशून्य
लम्बोष्ट->लम्बोष्ठ
लम्बोष्ट->लम्बौष्ठ
लवणखनि->लवणखानि
वयोधस->वायोधस
वर्वुर->वर्वूर
वला->वाला
वसतिवरी->वसतीवरी
वाणबार->वारबाण
वातापिसुदन->वातापिसूदन
विबध->विबाध
विषोषधी->विषौषधी
वृषि->वृषी
वेडमिका->वेढमिका
शठम्बा->शठाम्बा
शलङ->शालन
शिखिकण्ट->शिखिकण्ठ
शुकपिण्डी->शूकपिण्डि
शुकशिम्बी->शूकशिम्बी
शुण्टि->शुण्ठि
शुण्टि->शुण्ठी
शुष्कवेर->शुष्कवैर
श्रिय->श्रीय
श्रीकण्ठपदलाञ्चन->श्रीकण्ठपदलाञ्छन
श्रुतश्रोणि->श्रुतश्रोणी
सांक्रमिक->सांक्रामिक
सुखाशन->सुखासन
सुरदास->सूरदास
स्त्रीचोर->स्त्रीचौर
स्वर्णपाटक->स्वर्णपाठक
स्वल्पकेशरिन्->स्वल्पकेसरिन्
अफलित->अपलित
अपसम->अपशम
अभिवात्->अभिवत्
अवन्तीपुर->अवन्तिपुर
अवन्तीब्रह्म->अवन्तिब्रह्म
अवन्तीसोम->अवन्तिसोम
अस्वावेश->अस्ववेश
आग्निदात्तेय->आग्निदत्तेय
आजूर्->आजुर्
आरट्ठ->आरट्ट
आरठ्ठज->आरट्टज
आलगर्द्ध->आलगर्द्द
आषाढाभव->आषाढभव
ईला->इLआ
उकानह->उकनाह
उन्दूरु->उन्दुरु
ऋताषाह्->ऋताषह्
ऋश्यपाद्->ऋश्यपद्
एकशितिपाद्->एकशितिपद्
एषावीर->एषवीर
कन्दर्पमूषल->कन्दर्पमुषल
कपीकच्छू->कपिकच्छु
कपिकच्छूफलोपमा->कपिकच्छुफलोपमा
कपिकच्छूरा->कपिकच्छुरा
कपीकच्छू->कपीकच्छु
काबर->कबर
कामलाक्षी->कमलाक्षी
करास्फोट->करस्फोट
कर्करीक->कर्करिक
कल्याणवाचन->कल्याणवचन
कष्टकार->कष्टकर
कामासन->कामाशन
किङ्किणीका->किङ्किणिका
कूर्द्दन->कुर्द्दन
क्षारदेश->क्षणदेश
क्षुद्रकण्ठिका->क्षुद्रकण्टिका
क्षुद्रवर्वरा->क्षुद्रवर्वणा
खाङ्गाह->खङ्गाह
खस्फाटिक->खस्फटिक
गाडिक->गडिक
गृहचूल्ली->गृहचुल्ली
घटालाबू->घटालाबु
चटूल्लोल->चटुल्लोल
चलातङ्ख->चलातङ्क
चिच्छिटिङ्ग->चिच्चिटिङ्ग
चुरू->चुरु
चूचूक->चूचुक
चौण्ठ्य->चौण्ट्य
जज्झ->जज्ज
जम्बूवनज->जम्बुवनज
जलब्राह्मी->जलब्रह्मी
जलाषाह्->जलाषह्
जीमूतकूट->जीमूतकुट
डाहूक->डाहुक
तर्पिली->तर्पिलि
तीक्ष्णलौह->तीक्ष्णलोह
तृणजलायूका->तृणजलायुका
तैलद्रौणी->तैलद्रोणी
त्रिपाठ->त्रिपाट
त्रिलौहक->त्रिलोहक
थुथूकृत्->थुथुकृत्
दंशूक->दंशुक
दन्तसिरा->दन्तशिरा
दाशग्राम->दशग्राम
दिवावासु->दिवावसु
दृढक्षात्र->दृढक्षत्र
द्रौणीज->द्रोणीज
धार्म्मपत्तन->धर्म्मपत्तन
धवलयावानल->धवलयावनाल
धूस्तुर->धुस्तूर
नरासन->नराशन
नागालाबू->नागालाबु
नारीष्ट->नारिष्ट
नारीष्ट->नारिष्ठ
निर्द्धार->निर्द्दर
निर्द्धारित->निर्द्दारित
नीलि->निली
निसुन्ध->निसुन्द
नीललौह->नीललोह
पङ्कमण्डूक->पङ्कमण्डुक
पञ्चावी->पञ्चावि
पाणिकर्म्मन्->परिकर्म्मन्
पादगण्डीर->पादगण्डिर
पिङ्गललौह->पिङ्गललोह
पिप्पलीश्रोणि->पिप्पलिश्रोणि
पूर्ववाह्->पूर्ववह्
प्रख्यास्->प्रख्यस्
प्रणूत->प्रणुत
प्राशित्राहरण->प्राशित्रहरण
बलादि->बलदी
बालिहन्->बलिहन्
बृहत्कास->बृहत्काश
भक्ष्यालाबू->भक्ष्यालाबु
भावयू->भावयु
भास्कारेष्टा->भास्करेष्टा
महाप्रासाद->महाप्रसाद
मुथशील->मुथशिल
मुमूचान->मुमुचान
यज्ञायज्ञीय->यज्ञायज्ञिय
यमघण्ठ->यमघण्ट
रविलौह->रविलोह
रात्रिमाणि->रात्रिमणि
लाक्षाप्रसाधन->लाक्षाप्रसादन
वकारः->वकरः
वर्स्मन्->वर्श्मन्
वल्लीदूर्वा->वल्लिदूर्वा
वाचाठ->वाचाट
वाधूक्य->वाधुक्य
शास्त्रगत->शस्त्रघात
शालाङ्क->शालङ्क
शिम्बीपर्णी->शिम्बिपर्णी
शुकपिण्डी->शुकपिण्डि
सङ्घतल->सङ्गतल
समयाकार->समयकार
सारलौह->सारलोह
सुखाशन->सुकाशन
सूर्य्यमणी->सूर्य्यमणि
हिङ्गुसिराटिका->हिङ्गुशिराटिका
अभिघाति->अभिघाती
अयोध्याकाण्ड->अयोध्याखण्ड
अलगर्द्द->अलगर्द्ध
अवनिनाथ->अवनीनाथ
अष्टभुजा->अष्टाभुजा
इष्टवत्->इष्टावत्
उपशिङ्गन->उपशिङ्घन
ऊर्ज्जस्->ऊर्ज्जास्
कनि->कानी
कपोतवृत्ति->कापोतवृत्ति
करसुत्र->करसूत्र
गरुत्मन्->गरुत्मान्
घारि->घारी
चान्द्रायणि->चान्द्रायणी
चोरघात->चौरगत
छर्द्दपनिका->छर्द्दापनिका
छुरिकापत्री->छूरिकापत्री
जज्झ->जझ्झ
तपिनी->तापिनी
तप्तशूर्मिकुण्ड->तप्तसूर्मिकुण्ड
तरतम->तारतम
धराङ्गुर->धाराङ्गुर
परिकलित->परिकालित
पाठि->पाठी
पैङ्गलोदायनि->पैङ्गलौदयनि
पोतिमत्स्यक->पौतिमत्स्यक
प्रादि->प्राधी
प्रोढि->प्रौढी
बलादि->बलाधि
मशि->मासी
वसतिवरी->वसतीवरि
शालिनीकरणम्->शालीनीकरणम्
सम्बरारि->सम्भरणी
स्वुर्च्छ->स्वूर्च्छ
अतिभारः->अतिभरः
अफलित->अपालित
अयोध्याकाण्ड->अयोध्याकण्ड
असम्भृत->असम्बृत
और्द्ध्वदैहिक->और्द्ध्वदेहिक
कटकार->कटकर
गरस्->गणस्
घारि->गारि
तगरपादी->तगरपादि
देवधन->देवदान
दैवसर्ग->देवसर्ग
नारीष्ट->नरिष्ट
पञ्चपाद्->पञ्चपद्
पार्य्य->पर्य्य
पार्वायनान्तीया->पार्वायनान्तिया
पार्श्वी->पार्श्वि
पृथिवीञ्जय->पृथिविञ्जय
प्रादि->प्रदी
प्रामधि->प्रमादी
यदृच्छाशब्द->यदृच्छशब्द
शालाङ्क->शलङ्क
शुकशिम्बी->शुकशिम्बि
हरगीरी->हरगिरि
अतिपद->अतिपाद
अपचित्->अपाचित्
अपची->अपाची
अपण्य->अपार्य
अपद्->अपाद्
अपधा->अपादा
अपधा->अपाधा
अपमार्जन->अपामार्जन
अपमृत्यु->अपामृत्यु
अपयान->अपायन
अपराङ्मुख->अपराङ्मूख
अपरिवृत->अपरीवृत
अपवरक->अपवारक
अपवरण->अपावरण
अपवारण->अपावरण
अपशु->अपसू
अपशु->अपासु
अपश्री->अपाश्रि
अपस्->अपास्
अपसरण->अपसारण
अपसरण->अपासरण
अपस्कर->अपस्कार
अपहरण->अपहारण
अपाटव->अपाठव
अपांनप्त्रिय->अपांनप्त्रीय
अपि->अपी
अपुण्य->अपूर्य
अपुनर्भव->अपुनर्भाव
अपुराण->अपूरण
अपोगण्ड->अपौगण्ड
अपोनप्त्रिय->अपोनप्त्रीय
अप्रज->अप्राझ
अप्रतिकर->अप्रतीकार
अप्रतिकार->अप्रतीकार
अप्रतिघ->अप्रतीघ
अप्रतिभा->अप्रतीभा
अप्रतीत->अप्रथित
अब->अभ
अबधा->अबाधा
अब्भ्रिय->अब्भ्रीय
अब्रह्मण्य->अब्राह्मण्य
अभव्य->अभाव्य
अभिक्रम->अभिक्राम
अभिगत->अभीघात
अभिघात->अभीघात
अभिचर->अभीचार
अभिचरणीय->अभिचारणीय
अभिचार->अभीचार
अभिजात->अभिझात
अभिज्ञ->अभीज्य
अभिनिष्टान->अभिनिष्ठान
अभिप्रेप्सु->अभिप्रेफ्सु
अभिभवन->अभिभावन
अभिमानिन्->अभीमानिन्
अभियाति->अभियाती
अभिव्यक्ति->अभिव्यक्ती
अभिशस्->अभिशास्
अभिशाप->अभीशाप
अभिषाह्->अभीषह्
अभिषाह्->अभीषाह्
अभिष्टन->अभिष्ठान
अभिष्टि->अभीष्टि
अभिसर->अभीसार
अभिसरण->अभिसारण
अभिसार->अभीसार
अभ्युपगत->अभ्युपागत
अभ्युपगम->अभ्युपागम
अभ्युष->अभ्यूष
अभ्रि->अभ्री
अभ्रिय->अभ्रीय
अमनि->अमनी
अमनुष्य->अमानुष्य
अमन्तु->अमन्थु
अमम->अमाम
अमर->अमार
अमल->अमाल
अमस->अमास
अमावसी->अमावासी
अमावस्या->अमावास्या
अमित्रसह->अमित्रसाह
अमुक->अमुख
अमृतसू->अमृताशु
अम्ब->अंभ
अम्बर->अम्भण
अम्बुकेशर->अम्बुकेसर
अम्बुधर->अम्बुधार
अम्लकेशर->अम्लकेसर
अम्लिका->अम्लीका
अयज्ञिय->अयज्ञीय
अयत->अयथ
अयत->अयात
अयव->अयाव
अयवस्->अयावस्
अयस्->अयास्
अरण->अराण
अरणि->अरणी
अरणि->अराणि
अरण्य->अरर्य
अरत->अरथ
अरति->अरथी
अरद->अराध
अरम->अराम
अरर->अराण
अररि->अराणि
अरलु->अरालु
अर्द्धशन->अर्द्धाशन
अर्बुद->अर्बुध
अर्शस्->अर्सस्
अर्शस->अर्सस
अलक->अलाक
अलि->अली
अलिन->अलीन
अलिपक->अलीपक
अवकर->अवाकर
अवका->अवाका
अवकीर्ण->अवाकीर्ण
अवगीत->अवगीथ
अवगुण->अवगुर
अवग्रह->अवग्राह
अवचनीय->अवाचनीय
अवदारक->अवधारक
अवद्य->अवध्य
अवधि->अवधी
अवधि->अवादी
अवनति->अवनती
अवनि->अवनी
अवनिपति->अवनीपति
अवन्ति->अवन्ती
अवमान->अवामन
अवरतस्->अवारतस्
अवलम्ब->अवालम्ब
अवश्य->अवस्य
अवश्य->अवाश्य
अवस्->अवास्
अवसर->अवसार
अवसृष्ट->अवसृष्ठ
अवस्कर->अवस्कार
अवस्तु->अवास्तु
अविदूर->अविधुर
अविपाल->अविफल
अविरत->अविरथ
अवीचि->अवीची
अवेद्य->अवेध्य
अवेद्य->अवैद्य
अव्यभिचार->अव्यभीचार
अव्रत्य->अव्रात्य
अशन->अशान
अशनि->अशनी
अशब्द->अशाब्द
अशेव->अशैव
अश्मन्तक->अश्मान्तक
अश्रद्धेय->अश्राद्धेय
अश्वमुख->अश्वामुख
अश्वयु->अश्वायु
अश्ववत्->अश्वावत्
अश्वशृगालिका->अश्वसृगालिका
अष्टगव->अष्टागव
अष्टगृहीत->अष्टागृहीत
अष्टचत्वारिंशत्->अष्टाचत्वारिंशत्
अष्टतय->अष्टातय
अष्टदंष्ट्र->अष्टादंष्ट्र
अष्टदिश्->अष्टादिश्
अष्टपदिका->अष्टपादिका
अष्टपाद्->अष्टापद्
अष्टपाद्->अष्टापाद्
अष्टमङ्गल->अष्टमाङ्गल
अष्टरत्नि->अष्टारत्नि
अष्टापद->अष्टापाद
असद्ग्रह->असद्ग्राह
असनि->असानि
असन्दित->असन्धित
असहिष्णु->असाहिष्णु
असि->असी
असुख->असूक
असुसू->असूसु
असुसू->असूसू
असृग्धरा->असृग्धारा
अस्त->अस्थ
अस्ताघ->अस्थाघ
अस्ति->अस्ती
अस्ति->अस्थी
अस्त्रकण्टक->अस्त्रकण्ठक
अस्थाग->अस्थाघ
अस्थि->अस्थी
अहत->अहात
अहहा->अहाहा
अहि->अही
अहीरणि->अहीरणी
अहुत->अहूत
अह्रि->अह्री
आकर->आखण
आकरिक->आकारिक
आकरिन्->आकारिन्
आकार->आखण
आकुलि->आकुली
आकृति->आकृती
आके->आकै
आगत->आगथ
आगमिक->आगामिक
आगुर्->आगूर्
आगुरण->आगूरण
आङ्गिरस->आङ्गीरस
आचमनक->आचामनक
आचम्य->आचाम्य
आचरण->आचारण
आजकरोण->आजकरौण
आजगव->आजगाव
आजातशत्रव->आजातशात्रव
आज्ञप्ति->आज्ञाप्ति
आज्ञापत्र->आज्यपात्र
आज्यदोह->आज्यादोह
आडि->आडी
आणव->आराव
आणि->आरि
आणि->आरी
आतापि->आतापी
आति->आती
आतिरेक्य->आतिरैक्य
आतिश्वायन->आतिस्वायन
आत्त->आत्थ
आत्मवश्य->आत्मावास्य
आदर->आधर
आदातृ->आधातृ
आदान->आधन
आदायिन्->आधायिन्
आदार->आधर
आदि->आदी
आदि->आधी
आदिकर->आदिकार
आदित्यपत्र->आदित्यपात्र
आदित्सु->आधित्सु
आदिवराह->आदिवाराह
आदृत->आधृत
आद्य->आध्य
आधि->आधी
आधुत->आधूत
आधुनिक->आधूनिक
आनक->आनाक
आनकदुन्दुभि->आनकदुन्दुभी
आनमन->आनामन
आनमित->आनामित
आनस->आनाश
आनिलि->आनिली
आनिलि->आनीली
आनुश्रविक->आनुश्राविक
आन्तरिक्ष->आन्तरीक्ष
आपति->आपथी
आपतिक->आपातिक
आपतित->आपातित
आपथि->आपथी
आपदेव->आपादेव
आपस्तम्ब->आपस्तम्भ
आपातलिका->आपातालिका
आपीन->आफीन
आबिल->आभिल
आभीरपल्लि->आभीरपल्ली
आभु->आभू
आमलक->आमालक
आमिक्षा->आमीक्षा
आयज्यु->आयाज्यु
आयति->आयती
आयत्ति->आयत्ती
आयमन->आयमान
आयोद->आयोध
आरव->आराव
आरुणि->आरुणी
आलम्बन->आलम्भन
आलम्बिन्->आलम्भिन्
आलम्बिन्->आलंभिन्
आलि->आली
आवय->आवाय
आवसति->आवसथी
आवसित->आवासित
आवह->आवाह
आवुक->आवूक
आवेशिक->आवैशिक
आशय->आसय
आशर->आशार
आशव->आसाव
आशस्->आशास्
आशसन->आशासन
आशाढ->आसड
आशास्य->आसस्य
आशिन्->आसिन्
आशिन->आशीन
आशिर्->आशीर्
आशिस्->आशीस्
आशिस्->आसीस्
आशी->आसि
आशु->आसु
आशु->आसू
आशुशुक्षणि->आशुशुक्षणी
आशू->आसु
आशू->आसू
आश्रयण->आस्रायण
आश्रि->आश्री
आश्रिन्->आस्रिन्
आश्व->आस्व
आश्वतराश्वि->आश्वतरास्वि
आसदन->आसाधन
आसनी->आसानी
आसव->आसाव
आसादन->आसाधन
आसुरि->आसुरी
आस्तिकार्थद->आस्तीकार्थद
आस्तिक्य->आस्तीक्य
आस्फोट->आस्फोठ
आहुति->आहुती
आह्वय->आह्वाय
इक्->इख्
इक्->ईख्
इङ्->ईङ्
इज्य->ईज्य
इड्->ईड्
इण्->इर्
इण्->ईर्
इत्->ईत्
इत->ईत
इतस्->इथस्
इतिक->इतीक
इत्कट->इत्कठ
इद्->इध्
इदम्->इदाम्
इन्दि->इन्धि
इन्दि->इन्धी
इन्दिवर->इन्दीवर
इन्दुक->इन्धूक
इन्दुमणि->इन्दुमणी
इन्द्रियगोचर->इन्द्रियागोचर
इन्द्रियवत्->इन्द्रियावत्
इभकेशर->इभकेसर
इयत्->इयात्
इरा->ईरा
इराज->ईरज
इलिनी->ईलिनी
इली->ईली
इल्लिश->इल्लिस
इल्लिश->इल्लीस
इष्->ईष्
इषिका->ईषीका
इषीका->ईषीका
इषेत्वक->इषेत्वाक
इष्व->ईष्व
इस्->ईस्
इहामुत्र->इहामूत्र
ईक्षणिक->ईक्षणीक
ईड->ईढ
ईलि->ईली
ईश्->ईस्
ईषिका->ईषीका
उक्ति->उक्थि
उक्षण->उक्षाण
उच्च->उच्छ
उच्चलित->उच्छलित
उच्चलित->उच्छालित
उच्चावच->उच्चावाच
उच्छ्रय->उच्छ्राय
उच्छ्वसित->उच्छ्वासित
उज्जिति->उज्झिति
उज्ज्वलन->उज्ज्वालन
उञ्छशिल->उञ्छशील
उड->उढ
उडुप->उडूप
उड्डीयन->उड्डीयान
उड्र->उढ्र
उण्डुक->उण्डूक
उत्कलित->उत्कालित
उत्कुण->उत्कुर
उत्क्रम->उत्क्राम
उत्तब्ध->उत्थब्ध
उत्तरकाण्ड->उत्तरखण्ड
उत्तरङ्ग->उत्तराङ्ग
उत्तरतन्त्र->उत्तरातन्त्र
उत्तरफल्गुनी->उत्तरफाल्गुनी
उत्तरवेदि->उत्तरवेदी
उत्तिष्ठमान->उत्तिष्ठामान
उत्पट->उत्पाट
उत्पल->उत्फल
उत्पलशारिवा->उत्पलसारिवा
उत्पुत->उत्पूत
उत्सादन->उत्साधन
उदक्त->उदाक्त
उदन्->उधन्
उदन्त->उदान्त
उदय->उदाय
उदयन->उदयान
उदवाह->उदावह
उदसन->उदासन
उदहार->उदाहर
उदास->उधस
उदित->उदीत
उदुम्बर->उदुम्भर
उद्गता->उद्गाता
उद्गता->उद्गाथा
उद्गिरण->उद्गीरण
उद्दान->उद्धन
उद्दित->उद्धित
उद्धि->उद्धी
उद्भव->उद्भाव
उद्य->उध्य
उद्यति->उद्यती
उद्वपन->उद्वापन
उन्नति->उन्नती
उन्नमित->उन्नामित
उपक्वण->उपक्वाण
उपगम्य->उपागम्य
उपगा->उपागा
उपचय->उपचाय
उपचरित->उपाचरित
उपचार->उपाचार
उपचिति->उपचिती
उपदश->उपदास
उपदा->उपादा
उपदा->उपाधा
उपदिश्->उपादिश्
उपदी->उपधी
उपधा->उपादा
उपधा->उपाधा
उपधान->उपाधान
उपधि->उपधी
उपनयन->उपानयन
उपनायन->उपानयन
उपनाह->उपानह
उपयम->उपायम
उपयात->उपायात
उपयाम->उपायम
उपरम->उपारम
उपरम->उपाराम
उपराम->उपारम
उपराम->उपाराम
उपलभ्य->उपालभ्य
उपलिङ्ग->उपालिङ्ग
उपविद्->उपविध्
उपसद्->उपसाध्
उपसद्->उपासद्
उपसद->उपसाद
उपसदन->उपसादन
उपसद्य->उपसाद्य
उपसद्य->उपासाद्य
उपसर->उपाशार
उपस्तरण->उपास्तरण
उपस्ति->उपस्थि
उपस्थित->उपास्थित
उपहरण->उपाहरण
उपहार->उपाहार
उपहृत->उपाहृत
उपादान->उपाधान
उपादिक->उपाधिक
उपोदिका->उपोदीका
उमाकट->उमाकठ
उर->ऊर
उरण->उराण
उरश->उरस
उरी->ऊणि
उरीकृत->ऊरीकृत
उर्ज->ऊर्ज
उर्णा->ऊर्णा
उर्वरा->ऊर्वरा
उर्वारु->उर्वारू
उल->ऊल
उलुप->उलूप
उलुलि->उलूलि
उलूपी->ऊलुपी
उल्लल->उल्लाल
उल्लसन->उल्लासन
उल्लसित->उल्लासित
उशीर->उसीर
उषण->उषर
उष्ण->ऊष्ण
उष्मप->ऊष्मप
उष्माय->ऊष्माय
उस्रिय->उस्रीय
ऊति->ऊती
ऊर्म्मिमालिन्->ऊर्म्मीमालिन्
ऊलुपिन्->ऊलूपिन्
ऋच्->ऋछ्
ऋजु->ऋजू
ऋणापकरण->ऋणापाकरण
ऋतनि->ऋतनी
ऋति->ऋती
ऋतीषह्->ऋतीषाह्
ऋतु->ऋथु
ऋभुक्षिन्->ऋभुक्षीन्
ऋषिक->ऋषीक
एककर->एकाकर
एककर->एकाकार
एकरूप्य->ऐकरूप्य
एकवेणि->एकवेणी
एकशफ->ऐकशफ
एकाङ्ग->ऐकाङ्ग
एकान्त->ऐकान्त
एकीय->ऐकीय
एज्य->ऐज्य
एडुक->एडूक
एडुक->ऐडुक
एडुक->ऐडूक
एण->एर
एतश->ऐतश
एध->ऐध
एधा->ऐधा
एरण्ड->ऐरण्ड
एलक->ऐलक
एला->ऐला
एलाक->ऐलक
एलापत्र->ऐलपत्र
एलुक->एलूक
एषण->एषाण
एष्य->ऐष्य
ओकण->ओकार
ओकण->औकार
ओड->ओढ
ओणि->ओणी
ओम्->औम्
ओल->औल
ओषण->औषण
ओषधि->ओषधी
ओषधि->औषधी
ओषधिपति->ओषधीपति
ओषधिपति->औषधीपति
ओष्ण->औष्ण
औदरिक->औदारिक
औदास्य->औधस्य
औपगवि->औपगवी
औपनिषद->औपनिषध
औपयिक->औपायिक
औपरोधिक->औपरौधिक
औरसिक->औरसीक
औषधि->औषधी
कंसवती->कंसावती
ककर->ककार
कङ्क->काङ्क
कङ्कत->काङ्कत
कङ्करोल->कङ्करौल
कङ्ख->काङ्क
कङ्गु->कङ्गू
कङ्गुल->काङ्गुल
कङ्गुल->काङ्गूल
कच्चर->कच्छर
कच्चर->कच्छार
कच्छ->काच्छ
कच्छक->काच्छक
कच्छटिका->कच्छाटिका
कच्छप->काच्छप
कच्छु->कच्छू
कच्छुमती->कच्छूमती
कज->काज
कञ्चिका->काञ्चिका
कञ्चुकिन्->काञ्चुकिन्
कञ्चुलिका->कञ्चुलीका
कञ्जर->कञ्जाण
कटक->कठक
कटाकु->कठाकु
कटाक्ष->काटाक्ष
कटार->काटर
कटि->कटी
कटि->कठि
कटि->कठी
कटिल्ल->कठिल्ल
कटिसूत्र->कटीसूत्र
कटुकी->काटुकि
कटुर->कठुर
कट्वङ्ग->कट्वाङ्ग
कठर->काटर
कठिन->काठिन
कणाद->काणाद
कणिक->काणिक
कणीक->काणिक
कणीयस्->करीयस्
कणेर->करेर
कणेर->काणेर
कणेरु->करेणू
कण्टक->कण्ठक
कण्टक->काण्टक
कण्टकार->काण्टकार
कण्टकाल->कण्ठकाल
कण्टकिल->कण्टाकिल
कण्टिन्->कण्ठिन्
कण्डनी->काण्डनी
कण्डरीक->काण्डरिक
कण्डुर->कण्डूर
कण्व->काण्Vअ
कतक->काथक
कति->कथी
कथक->काथक
कद->कध
कदम्बक->कादम्बक
कदम्बी->कादम्बी
कदर->कदार
कदल->कादल
कदली->कादली
कद्रु->कद्रू
कद्रुण->कद्रूण
कद्रुपुत्र->कद्रूपुत्र
कधप्रिय->कधाप्रिय
कन->कान
कनकपल->कनकफल
कनी->कानी
कनीनी->कानिनी
कनीयस->कानीयस
कन्थक->कान्तक
कन्थरी->कन्थारी
कन्था->कान्ता
कन्याकुब्ज->कान्याकुब्ज
कपट->कापट
कपाट->कापट
कपालि->कपाली
कपालि->कापालि
कपालि->कापाली
कपालिका->कापालिका
कपि->कफी
कपि->कापी
कपिकच्छू->कपीकच्छु
कपिल->कफिल
कपिलधारा->कपिलाधारा
कपिशी->कापिशी
कपिष्ठल->कपिष्ठाल
कपोती->कापोति
कपोती->कापोती
कपोल->कापोल
कबन्ध->काबन्ध
कम्->काम्
कमठ->कामठ
कमन्तक->कामान्तक
कमन्ध->कामन्द
कमलकीट->कामलकीट
कमा->कामा
कम्पिल->कम्पील
कम्पिल->काम्पिल
कम्पिल्ल->कम्फिल्ल
कम्पिल्ल->काम्पिल्ल
कम्बु->कंबू
कम्बु->कंभु
कम्बु->कम्भू
कम्बू->कंभु
कम्बू->कम्भू
कम्भु->कम्भू
कयस्था->कायस्था
करकण्टक->करकण्ठक
करण्ड->कारण्ड
करद->काणाद
करपाल->कारापाल
करभोरु->करभोरू
करमर्द्द->करामर्द्ध
करम्भि->कारम्भि
करवी->कारावी
करशीकर->करसीकर
करिक->काणिक
करिकणवल्ली->करिकणावल्ली
करिन्->कारिन्
करुणमल्ली->करुणामल्ली
करूष->कारूष
करूषाधिपति->कारूषाधिपति
करेणु->करेणू
करोटक->कारोटक
कर्कटक->कार्कटक
कर्कटि->कर्कटी
कर्कर->कर्कार
कर्कर->कार्कण
कर्कि->कार्कि
कर्की->कार्कि
कर्कोट->कार्कोट
कर्ण->कार्ण
कर्णजप->कर्णजाप
कर्णाकर्णि->कर्णाकर्णी
कर्णाट->कार्णाट
कर्णाटक->कार्णाटक
कर्णि->कार्णि
कर्णी->कार्णि
कर्पण->कार्पाण
कर्पर->कार्पाण
कर्परी->कार्पणी
कर्पूर->कार्पूर
कर्फर->कार्पाण
कर्बु->कर्बू
कर्व->काण्Vअ
कर्षणि->कर्षणी
कलम->कलाम
कलम्बिका->कलाम्बिका
कलम्बी->कलम्भि
कलम्बी->कलाम्बि
कलश->कलास
कलशि->कलशी
कलशि->कलसी
कलशीसुत->कलसीसुत
कलशोदर->कलसोदर
कलस->कलास
कलसि->कलसी
कलि->कली
कलिद्रुम->कलिद्रूम
कल्कि->कल्की
कवटी->कवाटी
कवारि->कवारी
कवि->कवी
कशेरु->कशेरू
कशेरुमत्->कशेरूमत्
कशेरुमत्->कसेरुमत्
कांशि->कांसी
काकण->काकर
काकणन्ती->काकरन्ति
काकन्दि->काकन्दी
काकन्दि->काकान्दी
काकलि->काकली
काकु->काकू
काकोष्ठक->काकौष्ठक
काङ्गा->काङ्घा
काञ्चि->काञ्ची
काञ्जिक->काञ्जीक
काणुक->कारुक
काणूक->कारुक
काण्ठेविद्धि->काण्ठेविद्धी
कान्तलोह->कान्तलौह
कान्ति->कान्ती
कान्यकुब्ज->कान्याकुब्ज
काप्यकर->काप्यकार
कामचर->कामाचार
कामचार->कामाचार
कामन्दकि->कामन्दकी
कामशर->कामसार
कामि->कामी
कारकर->काराकार
कारभू->काराभू
कारवी->कारावी
कारुष->कारूष
कार्षि->कार्षी
कार्ष्णि->कार्ष्णी
कालकञ्ज->कालकाञ्ज
कालकण्टक->कालकण्ठक
कालनर->कालानर
कालनेमि->कालनेमी
कालमुख->कालामुख
कालरात्रि->कालरात्री
कालल->कालाल
काललोह->काललौह
कालशेय->कालसेय
कालानुशारिवा->कालानुसारिवा
कालियदमन->कालीयदमन
काशक->कासक
काशपरी->काशफरी
काशय->काशाय
काशि->कासी
काशिन्->कासिन्
काशिराज->काशीराज
काशी->कासी
काशू->कासू
काश्मरी->कास्मरी
काश्यप->कास्यप
काश्यपि->काश्यपी
काष्ठशारिवा->काष्ठसारिवा
काहलि->काहली
किंवदन्ति->किंवदन्ती
किंवदन्ति->किम्वदन्ती
किंशारु->किंसारु
किकि->किकी
किकिदिव->किकीदिव
किकीदिवि->किकीदीवि
किक्किश->किक्किस
किङ्कणी->किङ्करी
किङ्किणी->किङ्किरी
किङ्किणीकाश्रम->किङ्कीणिकाश्रम
किटि->कीटी
किणि->किणी
किम्->कीम्
किम्पुरुष->किंपूरुष
किम्पुरुष->किम्पूरुष
किरक->कीरक
किराति->किराती
किरिटि->किरिटी
किरिटि->किरीटी
किशर->किसर
किशोर->किसोर
कुक->कूक
कुकूल->कूकुल
कुक्कुटि->कुक्कुटी
कुक्षि->कुक्षी
कुचेल->कुचैल
कुजा->कूजा
कुज्जिश->कुज्झिश
कुज्झटि->कुज्झटी
कुञ्चि->कुञ्ची
कुटर->कुटार
कुटि->कूटि
कुटि->कूटी
कुटी->कूटि
कुटी->कूटी
कुठि->कूटि
कुठि->कूटी
कुडि->कुडी
कुणक->कुरक
कुणाल->कुराल
कुण्डलिका->कुण्डलीका
कुण्डिक->कुण्डीक
कुनट->कुनठ
कुन्तिभोज->कुन्तीभोज
कुपय->कूपाय
कुपिनी->कूपिनी
कुब->कूब
कुब->कूभ
कुब्र->कुभ्र
कुभ->कूब
कुभ->कूभ
कुम्भकारी->कुम्भाकारी
कुम्भिका->कुम्भीका
कुम्भीनसि->कुम्भीनसी
कुयव->कूयव
कुरङ्गनाभि->कुरङ्गनाभी
कुरट->कुरठ
कुरट->कुराट
कुरर->कुरार
कुरल->कुराल
कुरुण्ट->कुरुण्ठ
कुर्कुर->कूर्कुर
कुर्दन->कूर्दन
कुर्पास->कूर्पस
कुलधारक->कुलाधारक
कुलपालि->कुलपाली
कुलवत्->कूलवत्
कुलाल->कूलाल
कुलि->कूलि
कुलिक->कूलिक
कुलिन्->कूलिन्
कुली->कूलि
कुल्व->कूल्व
कुवेणि->कुवेणी
कुशर->कुसर
कुशल->कुशाल
कुशविन्दु->कुशाविन्दु
कुशाम्ब->कूशाम्ब
कुशाल्मलि->कुशाल्मली
कुशिक->कुसिक
कुशिम्बि->कुशिम्बी
कुशी->कुसि
कुशी->कुसी
कुशुम्भ->कुसुम्ब
कुशूलधान्यक->कुसूलधान्यक
कुहना->कूहना
कुहरित->कुहारीत
कुहलि->कुहली
कुहूरव->कुहूराव
कूटशाल्मलि->कूटशाल्मली
कृत्->कॄत्
कृत->कृथ
कृतश्रम->कृतश्राम
कृतसापत्निका->कृतसापत्नीका
कृताञ्जलि->कृताञ्जली
कृतावदान->कृतावधान
कृति->कृती
कृमि->कृमी
कृवि->कृवी
कृषि->कृषी
कृष्णगङ्गा->कृष्णागङ्गा
केकय->केकाय
केकर->केकाण
केतक->कैतक
केतुमालि->केतुमाली
केदर->कैदार
केदार->कैदार
केदारक->कैदारक
केनार->कैनर
केल->कैल
केलास->कैलाश
केलि->केली
केलिकिल->कैलिकिल
केवल->केवाल
केश->केस
केशराम्लः->केसराम्लः
केशव->कैशव
केशवादित्य->केशावादित्य
केशिनी->कैशिनी
केश्य->कैश्य
कोङ्कण->कोङ्काण
कोङ्कण->कोङ्कार
कोटक->कोठक
कोटि->कोठी
कोटिवर्षा->कोटीवर्षा
कोटिश->कोटीश
कोटी->कोठी
कोणि->खोरि
कोणि->खोरी
कोथ->कौत
कोर->कौर
कोरक->खोरक
कोलि->कोली
कोलि->कौलि
कोलि->कौली
कोलि->खोली
कोलूत->कौलूत
कोश->कोस
कोशला->कोसला
कोशला->कौसला
कोशलात्मजा->कोसलात्मजा
कोशी->कौसि
कोष्ठ->कौष्ठ
कोसल->कौसल
कोहल->कौहल
कोहित->कौहित
कौटि->खोटी
कौरुकत्य->कौरुकात्य
कौरुजङ्गल->कौरुजाङ्गल
कौलिक->कौलीक
कौशल->कौसल
कौशलि->कौसली
कौशली->कौसली
कौशलेय->कौसलेय
कौशल्य->कौसल्य
कौशल्या->कौसल्या
कौशल्यायनि->कौसल्यायनि
कौशिक->कौशीक
क्रथन->क्राथन
क्रमण->क्रामण
क्रमिक->क्रामिक
क्रय->क्राय
क्रयिक->क्रायिक
क्रेणि->क्रेणी
क्रोड->क्रौड
क्रोडी->क्रौडि
क्रौञ्चपदी->क्रौञ्चपादी
क्रौञ्चादन->क्रौञ्चादान
क्लिद->क्लिध
क्षणदाचर->क्षणदाचार
क्षणित->क्षरित
क्षति->क्षाति
क्षप्->क्षाप्
क्षमता->क्षामता
क्षमा->क्षामा
क्षमिन्->क्षामिन्
क्षरण->क्षारण
क्षान्ति->क्षान्ती
क्षिण->क्षिर
क्षीरषष्टिक->क्षीरषाष्टिक
क्षीरिका->क्षीरीका
क्षुण->क्षूण
क्षुद->क्षुध
क्षुर->क्षूण
क्षेत्रज्ञ->क्षैत्रज्ञ
क्षेत्रिय->क्षेत्रीय
क्षेपणि->क्षेपणी
क्षेमफला->क्षेमाफला
क्षोण->क्षोर
क्षोणि->क्षोणी
क्षोणि->क्षौणि
क्षोणि->क्षौरी
क्षौणी->क्षौरी
क्ष्णु->क्ष्णू
खङ्कर->खङ्खण
खङ्कर->खङ्खर
खङ्गपत्र->खङ्गपात्र
खङ्गीक->खाङ्गिक
खञ्जन->खाञ्जन
खञ्जार->खाञ्जार
खञ्जाल->खाञ्जाल
खटिक->खटीक
खटिका->खाटिका
खटी->खाटी
खट्वाङ्गधर->खट्वाङ्गधार
खडिक->खाडिक
खडी->खाडी
खडु->खडू
खड्ग->खाड्ग
खड्गिक->खड्गीक
खड्गिक->खाड्गिक
खण्डक->खाण्डक
खण्डसर->खण्डसार
खण्डिक->खण्डीक
खदिका->खादिका
खदिर->खादिर
खदिरसार->खादिरसार
खदिरी->खादिरी
खदूरक->खादूरक
खनिनेत्र->खनीनेत्र
खनी->खानी
खन्य->खान्य
खरिका->खरीका
खरिका->खारिका
खरीजङ्घ->खारीजङ्घ
खरु->खाणु
खर्जु->खर्जू
खर्द्द->खर्द्ध
खर्वुरा->खर्वूरा
खलधान->खलाधान
खलि->खली
खलिन->खलीन
खशीर->खाशीर
खशीर->खासीर
खाटि->खाटी
खानि->खानी
खारि->खारी
खुर->खूर
खुर्द्द->खूर्द्द
खोटि->खोटी
खोलि->खोली
खोल्मुक->खोल्मुख
ख्याति->ख्याती
गङ्गाधर->गङ्गाधार
गज->गाज
गजदान->गजादन
गजानन->गजानान
गड्डरिका->गड्डारिका
गड्डुक->गड्डूक
गणश्रि->गणश्री
गणिका->गरिका
गणित->गरित
गण्डु->गण्डू
गति->गती
गदा->गधा
गदाभृत्->गधाभृत्
गदित->गधित
गन्दिका->गन्धिका
गन्धकुटी->गन्धकूटी
गन्धमादन->गन्धमाधन
गन्धशुण्डिनी->गन्धाशुण्डिनी
गन्धारि->गन्धारी
गन्धोतु->गन्धौतु
गभस्ति->गभस्ती
गमिन्->गमीन्
गमिष्ठ->गमीष्ठ
गर्ग->गर्घ
गर्भद->गर्भाद
गर्भध->गर्भाद
गर्मुटिका->गर्मूटिका
गविनी->गवीनि
गविनी->गवीनी
गविष्टि->गविष्ठि
गाढमुष्टि->गाढमुष्ठि
गाण्डिव->गाण्डीव
गातव्य->घातव्य
गान्दिनी->गान्धिनी
गालि->गाली
गिरि->गिरी
गिरि->घिणि
गिरियक->गिरीयक
गिरियाक->गिरीयक
गीत->गीथ
गुटिका->घुटिका
गुडक->गूढक
गुडा->गूढा
गुडाशय->गूढाशय
गुडुची->गुडूची
गुणक->घुणक
गुणिका->घुरिका
गुन्दल->गुन्दाल
गुप्ति->गुप्ती
गुरण->गूरण
गुरण->घुरण
गुरु->गुरू
गुर्जर->गूर्जर
गुर्द्द->गूर्द्द
गुह->गूह
गृहु->गृहू
गेव->गैव
गो->गौ
गोकण्टक->गोकण्ठक
गोज->गोझ
गोजि->गोजी
गोड->घोड
गोणी->गौणी
गोणी->घोणी
गोणी->घोरी
गोतमान्वय->गौतमान्वय
गोतमीपुत्र->गौतमीपुत्र
गोद->गोध
गोद->गौद
गोधर->गोधार
गोधेर->गौधेर
गोनस->गोनास
गोनस->घोनस
गोप->गौप
गोपायन->गौपायन
गोपालि->गौपालि
गोपाली->गौपालि
गोपिल->गोफिल
गोपिल->गौफिल
गोभिल->गौभिल
गोमय->गौमय
गोयूति->गोयूथी
गोरण->घोरण
गोरथ->गौरथ
गोराटिका->गौराटिका
गोरिका->गौरिका
गोरिका->घोरिका
गोर्द->गोर्ध
गोलन्द->गौलन्द
गोला->गौला
गोला->घोला
गोवीथि->गोवीथी
गोशृङ्ग->गौशृङ्ग
गोषद्->घोषद्
गोषादी->घोषादी
गोष्ठि->गौष्ठी
गोष्ठी->गौष्ठी
गोह->गौह
गोह्य->गौह्य
गौड->घोड
गौण->घोण
गौणिक->घोणिक
गौपिलेय->गौफिलेय
गौर->घोण
गौरि->घोणी
गौरि->घोरी
गौरिक->घोणिक
गौरिवीति->गौरीविति
गौरी->घोणी
गौरी->घोरी
ग्रथ->घ्रात
ग्रन्थकुटी->ग्रन्थकूटी
ग्रन्थि->ग्रन्थी
ग्रहण->ग्राहण
ग्राम्यशूकर->ग्राम्यसूकर
घटक->घाटक
घटा->घाटा
घटाल->घाटल
घटिक->घाटिक
घटिका->घटीका
घटिघट->घटीघट
घटी->घाटि
घण्टक->घाण्टक
घण्टकर्ण->घण्टाकर्ण
घण्टाक->घाण्टक
घण्टापाटलि->घण्टापाटली
घर्घुर्घा->घर्घूर्घा
घुटि->घुटी
घुणि->घूरी
घुरी->घूरी
घुर्घुरक->घुर्घूरक
घृष्टिला->घृष्ठिला
घोलि->घोली
घोषक->घौषक
घोषादि->घोषादी
चक्रधर->चक्रधार
चक्रि->चक्री
चञ्चु->चञ्चू
चटिका->चठिका
चण्->चर्
चतुरश्र->चतुरस्र
चतुष्पद->चतुष्पाद
चतुष्पदी->चतुष्पादी
चतुस्तन->चतुस्थान
चन्दन->चन्धन
चन्दनशारिवा->चन्दनसारिवा
चन्द्रगिरि->चन्द्रगिरी
चन्द्रलोहक->चन्द्रलौहक
चन्द्रिका->चन्द्रीका
चमीकर->चमीकार
चरणि->चारणी
चरथ->चराथ
चरथ->चारथ
चराचर->चारचण
चरि->चरी
चरित->चारित
चरित्र->चरीत्र
चर्चिक्य->चार्चिक्य
चर्षणि->चर्षणी
चला->छला
चला->छाला
चलु->चलू
चवि->चवी
चवि->छावी
चाङ्ग->छङ्ग
चाट->छाट
चाणक->छरक
चाणक->छाणक
चात्र->छत्र
चात्र->छात्र
चान्द्रभागा->छन्द्रभागा
चाप->छप
चापल->चापाल
चाय->छाय
चायु->छयु
चारक->छरक
चारक->छाणक
चारुकेशरा->चारुकेसरा
चालक->छलक
चिकित्वन्->चिकित्वान्
चिक्कण->छिक्कण
चिट->छीट
चिटी->चीटी
चिटी->छिटि
चिति->चिती
चिति->चीति
चित्कार->चीत्कार
चित्ति->चित्ती
चित्रवहा->चित्रवाहा
चिप्पिका->छिप्पिका
चिर->चीण
चिरण्टी->चिरण्ठी
चिरतिक्त->चिरातिक्त
चिरम्भण->चीराम्बर
चिरि->चीरी
चिरिण्टी->चिरिण्ठी
चिलिचिम->चिलिचीम
चिलिचिम->चिलीचिम
चिविल्लिका->चीविल्लिका
चीनपिष्ट->चीनपिष्ठ
चीरि->चीरी
चुचुक->चूचुक
चुचू->चूचु
चुचूक->चूचुक
चुड->चूड
चुड्ड->छुड्ड
चुरण->छुरण
चूर्णि->चूर्णी
चेकित->चैकित
चेकितान->चैकितान
चेतकी->चैतकि
चेत्तृ->छेत्तृ
चेदि->चेदी
चेदि->छेदी
चेलाशक->चैलाशक
चेलिका->छेलिका
चैत्ररथि->चैत्ररथी
चैदिक->छेदिक
चोक्ष->चौक्ष
चोर->चौण
चोरक->चौरक
चोरिका->चौरिका
चोल->चौल
छगलक->छागलक
छच्छिका->छाच्छिका
छटा->छाटा
छत्त्रक->छात्त्रक
छत्त्राक->छात्त्रक
छन्द->छान्द
छन्दु->छन्दू
छन्दोग->छन्दोघ
छन्दोग->छान्दोग
छन्दोम->छान्दोम
छन्दोमान->छान्दोमान
छर्दिका->छर्दीका
छवि->छावी
छुच्छु->छुच्छू
छेदि->छेदी
छो->छौ
जगर->जगार
जघन->जघान
जघन->जाघन
जङ्गल->जङ्घल
जङ्गाल->जङ्घल
जङ्गिड->जङ्गीड
जङ्घाकरिक->जङ्घाकारिक
जटामांसी->जाटामांसी
जटि->जटी
जनत्->जानत्
जनन->जानन
जनन->जानान
जनपद->जानपाद
जनरव->जनारव
जनश्रुति->जानश्रुति
जनि->जनी
जनि->जानि
जनि->जानी
जनित->जनिथ
जन्मभूमि->जन्मभूमी
जप्य->जाप्य
जबाला->जाबाला
जमदग्नि->जामदग्नि
जम्बाल->जम्भल
जम्बु->जम्बू
जम्बुक->जम्बूक
जम्बुक->जाम्बुक
जम्बुद्वीप->जम्बूद्वीप
जम्बूनदी->जाम्बूनदी
जम्बूलमालिका->जाम्बूलमालिका
जम्भ->जाम्ब
जम्भ->जाम्भ
जय->जाय
जयद्रथ->जायद्रथ
जयन्त->जायन्त
जयन्ती->जायन्ती
जयसिंह->जयासिंह
जयादित्य->जयाधित्य
जरठ->जराट
जरण->जरर
जरद्गव->जारद्गव
जरिन्->जारिन्
जलकाङ्क्ष->जलाकाङ्क्ष
जलधि->जलधी
जलधि->जालधि
जलपूर->जालपुर
जलमार्ग->जालमार्ग
जलमोद->जलामोद
जलवास->जलावास
जलशायिन्->जलाशायिन्
जलशूकर->जलसूकर
जलह्रद->जालह्रद
जलालुक->जलालूक
जलाष->जालाष
जलाष्टीला->जलाष्ठीला
जलोका->जलौका
जव->जाव
जवनिका->जावनिका
जवनी->जवानी
जवादि->जावादि
जविन->जवीन
जहक->जहाक
जहल्लक्षणा->जहाल्लक्षणा
जातवेदस्->जातावेदस्
जातिकोश->जातीकोश
जातिफल->जातीफल
जातिशस्य->जातिसस्य
जानकि->जानकी
जानपद->जानपाद
जामि->जामी
जि->जी
जिङ्गी->जिङ्घि
जित->जीत
जितकाशि->जितकाशी
जितकाशिन्->जितकासिन्
जिवाजिव->जिवाजीव
जिह्वल->जिह्वाल
जीवादान->जीवाधान
जु->झु
जुटक->जूटक
जुटिका->जूटिका
जुर्व->जूर्व
जुष->झूष
जू->झु
जूर्णि->जूर्णी
जूष->झूष
जृ->झॄ
जॄ->झॄ
जेत्व->जैत्व
जेन्य->जैन्य
जोटिङ्ग->जोटीङ्ग
ज्ञ->ज्य
ज्ञपित->ज्ञापित
ज्ञप्ति->ज्ञाप्ति
ज्ञान->ज्यान
ज्ञेय->ज्येय
ज्येष्ठसामन्->ज्यैष्ठसामन्
ज्यो->ज्यौ
ज्योतिष->ज्यौतिष
ज्योतिषिक->ज्योतिषीक
ज्योत्स्नी->ज्यौत्स्नी
ज्वर->ज्वार
ज्वलन->ज्वालन
झटा->झाटा
झटि->झाटि
झर्च->झर्छ
झर्झर->झार्झर
झर्झरीक->झार्झरिक
झला->झाला
झल्लिका->झल्लीका
झाटल->झाटाल
झाटिका->झाटीका
झावु->झावू
झिरिका->झिरीका
झिरिका->झीरिका
टक->टाक
टक->ठक
टक्क->ठक्क
टक्कदेशीय->टक्कादेशीय
टङ्कण->टाङ्कार
टङ्कार->टाङ्कार
टल->टाल
टा->ठा
टाङ्कर->टाङ्कार
टार->ठार
टिटिभ->टीटिभ
टिट्टिभ->टीट्टिभ
टुण्टुक->टुण्ठुक
टोट->टौट
ट्वल->ट्वाल
डङ्गरी->डङ्गारी
डम्बर->डम्बार
डहु->डहू
डुलि->डुली
डोर->ढौर
ढण्टी->ढण्ठी
णद->णाध
तक्षक->ताक्षक
तडाक->ताडक
तडाघात->ताडघात
तडि->ताडी
तण्डक->ताण्डक
तण्डि->तण्डी
तण्डि->ताण्डि
तण्डुलिकाश्रम->तण्डूलिकाश्रम
तत्->तात्
ततर->ततार
तत्काल->तात्काल
तथागत->ताथागत
तथ्य->तात्य
तद्धित->ताद्धित
तनुभव->तनुभाव
तनुभव->तनूभव
तनुह्रद->तनूह्रद
तनूकृत->तनूकृथ
तन्ति->तन्ती
तन्ति->तान्ति
तन्त्र->तान्त्र
तन्थी->तान्ति
तन्द्रि->तन्द्री
तन्नि->तन्नी
तपती->तापती
तपनी->तापनि
तपनी->तापनी
तपित->तापित
तपुषि->तपुषी
तपोरति->तपोराति
तमाल->तामल
तमि->तमी
तमि->तामि
तमि->तामी
तमिषीचि->तमिषीची
तरङ्ग->तारङ्ग
तरस्->तरास्
तरस्थान->तारस्थान
तरिक->तरीक
तरिक->तारिक
तरिणी->तारिणी
तरीष->तारीष
तरुतृ->तरूतृ
तर्क->तार्क
तर्णि->तार्णि
तर्पण->तर्पर
तर्य->तार्य
तलक->तलाक
तलक->तालाक
तला->ताला
तलिका->तालिका
तलुन->तालुन
तल्प->ताल्प
तविष->तवीष
तविष->तावीष
ताडि->ताडी
तालक->तालाक
तालावचर->तालावचार
ताविष->तावीष
तिण्टी->तिण्ठी
तितिल->तितील
तिथि->तिथी
तिन्दुकि->तिन्दुकी
तिमि->तिमी
तिमिर->तिमीर
तिरस्करिणी->तिरस्कारिणी
तीरग्रह->तीरग्राह
तीर्थसेनि->तीर्थसेनी
तुडि->तुडी
तुणि->तुरी
तुणि->तूणि
तुणिक->तूणिक
तुण्डि->तुण्डी
तुथ->तूत
तुथ->तूथ
तुमुल->तुमूल
तुम्बि->तुम्बी
तुम्बुरु->तुम्बूरु
तुरम्->तूरम्
तुरि->तुरी
तुरि->तूणि
तुला->तूला
तुलाकोटि->तुलाकोटी
तुलादान->तुलाधान
तुलाधर->तुलाधार
तुलाप्रग्रह->तुलाप्रग्राह
तुलि->तुली
तुलि->तूली
तुवि->तुवी
तुहर->तुहार
तूर्णि->तूर्णी
तूलि->तूली
तृणपुली->तृणपूली
तृतीयप्रकृति->तृतीयाप्रकृति
तृप्ति->तृप्ती
तेजन->तैजन
तैलक्य->तैलाख्य
तैलपक->तैलपाक
तोक->तौक
तोद->तौद
त्रपुस->त्रापुस
त्रिंशति->त्रिंशती
त्रिकाण्ड->त्रिखण्ड
त्रिणव->त्रिराव
त्रिदलिका->त्रिदालिका
त्रिपताक->त्रिपथक
त्रिपदी->त्रिपादी
त्रिपुण्ड्र->त्रिपुण्ढ्र
त्रिपुरभैरवी->त्रिपुराभैरवी
त्रिपुरारि->त्रिपुरारी
त्रिपुरुष->त्रिपूरुष
त्रिभण्डी->त्रिभाण्डी
त्रिशरण->त्रिसरण
त्रुटि->त्रुटी
त्रुप->त्रुफ
त्रैविद्य->त्रैविध्य
त्रोटि->त्रोटी
त्र्युषण->त्र्यूषण
त्वच->त्वाच
त्सर->त्सार
थुत्कार->थूत्कार
दंशन->दंसन
दंष्ट्रिका->दंष्ट्रीका
दक्षाय्य->दाक्षाय्य
दक्षिणा->दाक्षिणा
दक्षिणीय->दाक्षिणीय
दण्डक->दाण्डक
दण्डनायक->दाण्डनायक
दण्डपांशुल->दण्डपांसुल
दण्डयाम->दण्डायाम
दत्->दात्
दत्त->दत्थ
दत्त->दात्त
दत्तेय->दात्तेय
ददन->दधन
ददन->दधान
दद्रुघ्न->दद्रूघ्न
दद्रुण->दद्रूण
दधिमुख->दधीमुख
दन्तक->दान्तक
दन्तपवन->दन्तपावन
दन्तोलुखलिक->दन्तोलूखलिक
दभ->दाभ
दम्->दाम्
दमन->दामन
दमिन्->दामिन्
दमुनस्->दमूनस्
दम्भ->दाम्भ
दया->दाया
दयावीर->दायविर
दर->दाण
दरणि->दारणी
दरि->दरी
दरि->दाणि
दरिद्र->दारिद्र
दरिन्->दारिन्
दरोदर->दारोदर
दर्दुर->दार्दूर
दर्द्रु->दर्द्रू
दर्द्रुघ्न->दर्द्रूघ्न
दर्वि->दर्वी
दर्विहोम->दर्वीहोम
दर्शक->दार्शक
दलि->दली
दलि->दाली
दलिन्->दालिन्
दल्य->दाल्य
दवदहन->दावदहन
दशक->दाशक
दशक->दासक
दशकण्ठ->दाशकण्ठ
दशग्रामिक->दाशग्रामिक
दशत्->दाशत्
दशतय->दाशतय
दशति->दशती
दशति->दासति
दशदशिन्->दशादशिन्
दशन->दसन
दशनोच्छिष्ट->दशनोच्छिष्ठ
दशपुर->दासपूर
दशपुरुष->दशपूरुष
दशपूर->दासपूर
दशस्य->दशास्य
दशार्ण->दाशार्ण
दशार्ह->दाशार्ह
दशार्ह->दासर्ह
दशाश्वमेध->दाशाश्वमेध
दशेरक->दशैरक
दशेरक->दासेरक
दसेरक->दासेरक
दहन->दाहन
दार्दुर->दार्दूर
दालि->दाली
दाशपुर->दासपूर
दाशमेय->दासमेय
दाशेय->दासेय
दाशेरक->दासेरक
दिधिषु->दिधीषु
दिधिषू->दिधीषु
दिनकृत्->दीनकृत्
दिनमुख->दीनमुख
दिनादि->दीनधी
दिव्->दीव्
दिवन्->दीवान्
दिवि->दीवि
दिवी->दीवि
दिव्यमान->दीव्यमान
दीदि->दीदी
दीदि->दीधि
दीर्घकण्टक->दीर्घकण्ठक
दीर्घनाल->दीर्घानल
दुग्धिका->दुग्धीका
दुन्दुभि->दुन्दुभी
दुन्दुभिस्वन->दुन्दुभिस्वान
दुरवग्रह->दुरवग्राह
दुरिष्ट->दुरिष्ठ
दुर्गल->दुर्गाल
दुर्दुरूट->दुर्धुरूट
दुर्मति->दुर्मती
दुर्वस->दुर्वास
दुर्वह->धुर्वह
दुलि->दुली
दुलि->धूली
दुष->दूष
दुष->धूष
दूणाश->दूणास
दूति->दूती
दूति->धुति
दूर->धुर
दूर->धूण
दूर्य->धुर्य
दूर्य->धूर्य
दूर्वा->धूर्वा
दूलाश->दूलास
दूली->धूली
दूषण->धूषर
दूषि->दूषी
दूषिका->दूषीका
दृ->धॄ
दृक->धृक
दृक्पथ->दृक्पात
दृढच्युत->दृढाच्युत
दृढनेमि->धृढनेमि
दृढसेन->धृढसेन
दृति->धृती
दृन्->धृङ्
दृशि->दृशी
दृष्टिविष->दृष्टीविष
दॄ->धॄ
देवकी->दैवकी
देवगण->देवागार
देवगिरि->देवगिरी
देवजन->दैवजन
देवता->दैवता
देवताप्रतिमा->दैवतप्रतिमा
देवदर्श->देवादर्श
देवनिद्->देवनीद्
देवनिर्मित->दैवनिर्मित
देवपुत्र->दैवपुत्र
देवमत->देवमात
देवयजि->देवयाजी
देवयु->देवयू
देवयु->देवायु
देवयु->देवायू
देवरक्षित->दैवरक्षित
देवरथ->दैवरथ
देवराज->दैवराज
देवरात->दैवरथ
देववात->दैववात
देववीति->देववीती
देवव्रत->देवव्रात
देवहव्य->दैवहव्य
देवहूति->देवहूती
देवानीक->दैवानीक
देवावास->दैववश
देवावृध्->दैवावृध्
देवावृध->दैवावृध
देविक->देवीक
देविन्->दैविन्
देवेज्य->दैवेज्य
देशक->देशाख
देहलि->देहली
दैवाहोरात्र->दैवाहौरात्र
दोस्->दौश्
दौहित्रायण->दौहित्रायाण
द्यावाक्षमा->द्यावाक्षामा
द्युति->द्युती
द्यो->द्यौ
द्योत->द्यौत
द्योतन->द्यौतान
द्योभूमि->द्योभूमी
द्रवि->द्रवी
द्रविण->द्राविण
द्रविणोदस्->द्रविणोदास्
द्रव्य->द्राव्य
द्राक्->द्राख्
द्रुड->द्रुढ
द्रुणस->द्रुणास
द्रुणि->द्रुणी
द्रुपद->द्रुपाद
द्रोघ->द्रौघ
द्रोणि->द्रोणी
द्रोणि->द्रौणि
द्रोणि->द्रौणी
द्रौणायन->द्रौणायान
द्वयु->द्वायू
द्वादशकर->द्वादशाकार
द्वारपालक->द्वारफलक
द्वारवती->द्वारावती
द्वितीयिक->द्वितीयीक
द्वित्र->द्वीत्र
द्विपदिका->द्विपादिका
द्विवेशरा->द्विवेसरा
द्विसहस्र->द्विसाहस्र
धनक->धनाक
धनक->धानाक
धनद->धानद
धनवत्->धानावत्
धनाश्री->धानश्री
धनिक->धानिक
धनिन्->धानिन्
धनुर्ग्रह->धनुर्ग्राह
धनुर्वेद->धानुर्वेद
धनुष->धानुष
धनुष्कर->धनुष्कार
धनेयक->धानेयक
धन्याक->धान्यक
धन्वन->धान्वन
धन्वन्तर->धान्वन्तर
धमनि->धमनी
धमनि->धामनी
धरणि->धरणी
धरणि->धारणि
धरणिधर->धरणीधर
धरणिरुह->धरणीरुह
धर्मदार->धर्मधर
धर्मपत्तन->धार्मपत्तन
धर्मभगिनी->धर्मभागिनी
धर्म्य->धार्म्य
धर्षणि->धर्षणी
धानक->धानाक
धामशस्->धामसश्
धारय->धाराय
धावनि->धावनी
धिष्ट्य->धिष्ठ्य
धीलटि->धीलटी
धुक्ष->धूक्ष
धुनि->धुनी
धुर्->धूर्
धुस्तुर->धुस्तूर
धूमपथ->धूमपात
धूमिका->धूमीका
धूलि->धूली
धूश->धूस
धृ->धॄ
धृति->धृती
धेनुक->धेनूक
धोर->धौर
धोरणि->धोरणी
धौतरि->धौतरी
ध्यानजप्य->ध्यानजाप्य
ध्रज->ध्राज
ध्रण->ध्राण
ध्रु->ध्रू
ध्वण->ध्वर
ध्वनि->ध्वनी
नक्->नख्
नकिम्->नकीम्
नक्र->नाक्र
नक्षत्रपथ->नक्षत्रपात
नखरी->नखारि
नखरी->नाकारि
नखि->नाकी
नखी->नाकी
नगभिद्->नागभिद्
नगारि->नागारि
नग्नजित्->नाग्नजित्
नग्नहु->नग्नहू
नञ्->नय्
नटसूत्र->नाटसूत्र
नडक->नाडक
नडश->नडस
नति->नाति
नदर->नादर
नदी->नादि
नदीमुख->नदीमूख
ननन्द->नानन्द
ननु->नानू
नन्द->नान्द
नन्दकि->नन्दकी
नन्दन->नान्दन
नन्दि->नन्दी
नन्दि->नान्दि
नन्दिक->नन्दीक
नन्दिक->नान्दिक
नन्दिन्->नान्दिन्
नन्दिपुराण->नन्दीपुराण
नन्दिमुख->नन्दीमुख
नन्दिवृक्ष->नन्दीवृक्ष
नपुंसक->नापुंसक
नभग->नभाग
नभनु->नभनू
नमित->नामित
नमी->नामि
नम्य->नाम्य
नम्र->नाम्र
नयन->नायन
नरकपाल->नारकपाल
नरकेशरिन्->नरकेसरिन्
नरसिंह->नारसिम्ह
नराची->नाराची
नरिष्ठा->नारीष्टा
नरी->नाणी
नरी->नारि
नर्द्दटक->नर्द्धटक
नलक->नालक
नलकिनी->नालकिनि
नलकिनी->नालकिनी
नलिका->नालिका
नलिन->नालिन
नलिनी->नालिनी
नलिनी->नालीनी
नव->नाव
नवति->नवती
नवनीत->नावनीत
नवशस्य->नवसस्य
नवशस्येष्टि->नवसस्येष्टि
नश्->नास्
नशाक->नाशक
नस्->नास्
नस्य->नाश्य
नहि->नही
नाकुलि->नाकुली
नागरी->नागारि
नाडिका->नाडीका
नाडिपत्र->नाडीपात्र
नाभि->नाभी
नाभिल->नाभील
नाविक->नावीक
निःशूक->निःसुख
निःशूक->निःसूक
निःश्रेणि->निःश्रेणी
निकर->निखर
निकार->निखर
निगण->निगर
निगण->निगार
निगद->निगाद
निचुल->निचूल
निजधृति->निजधृती
निटल->निटाल
निदातृ->निधातृ
निपठ->निपाठ
नियति->नियती
नियमन->नियामन
निरमित्र->निरामित्र
निरय->निराय
निरशन->निराशन
निरशन->निरासन
निरसन->निराशन
निरसन->निरासन
निरस्त->निरास्थ
निरुपाख्य->निरूपाख्य
निर्गुण->निर्घुण
निर्दर->निर्धार
निर्मथ->निर्मात
निर्मथ->निर्माथ
निर्माण->निर्मार
निर्वहण->निर्वाहण
निर्वेद->निर्वेध
निर्हरण->निर्हारण
निलय->निलाय
निलय->नीलाय
निलयन->निलायन
निवसन->निवासन
निवारण->नीवरण
निविद्->नीविद्
निवृत->नीवृत
निवेष्य->नीवेष्य
निशा->नीशा
निशित->निशिथ
निशित->निसित
निशीथ->निसित
निशुम्भ->निसुम्भ
निश्चय->निश्छाय
निश्चिरा->निश्चीरा
निश्वास->निस्वास
निषदन->निषधन
निष्काशित->निष्कासित
निष्कुट->निष्कूट
निष्कुटि->निष्कुटी
निष्क्रम->निष्क्राम
निष्क्रमण->निष्क्रामण
निष्टि->निष्ठी
निष्ट्य->निष्ठ्य
निष्ठुरिक->निष्ठूरिक
निष्पत्ति->नीष्पत्ति
निष्पद->नीष्पद
निसर->नीसाण
निसार->नीसाण
निस्तन्द्रि->निस्तन्द्री
निस्तरण->निस्तारण
निस्रव->निस्राव
नीलङ्गु->नीलाङ्गु
नीलमणि->नीलमाणि
नीवि->नीवी
नीशार->नीसाण
नु->नू
नृकेशरिन्->नृकेसरिन्
नृति->नृती
नृपति->नृपती
नेपथ्य->नैपथ्य
नेमि->नेमी
नेष्ट->नैष्ट
नैयमिक->नैयामिक
नैराश्य->नैरास्य
नैषादि->नैषादी
नोधस्->नोधास्
न्यङ्कुभूरुह->न्यङ्कुभूरूह
न्युङ्ख->न्यूङ्ख
पक्ति->पक्ती
पक्षति->पक्षती
पङ्कशूरण->पङ्कसूरण
पङ्क्ति->पङ्क्ती
पचन->पचान
पञ्चचितिक->पञ्चचितीक
पञ्चबाण->पञ्चभार
पञ्चशर->पञ्चसार
पञ्चशर->पञ्चाशर
पञ्चशस्य->पञ्चसस्य
पञ्चशाख->पञ्चाशक
पञ्जि->पञ्जी
पट्->पठ्
पटक->पठक
पटत्->पठत्
पटाक->पठक
पटि->पटी
पटु->पटू
पट्ट->पट्ठ
पट्टिश->पट्टिस
पणन->परान
पणाङ्गना->पराङ्गना
पणाया->पराया
पणि->पणी
पतङ्गिका->पतङ्घिका
पतत्->पथत्
पतद्ग्रह->पतद्ग्राह
पति->पथि
पति->पथी
पतिष्ठ->पथिष्ठ
पत्ति->पत्ती
पत्त्राङ्गुलि->पत्त्राङ्गुली
पथिन्->पथीन्
पदवि->पदवी
पदि->पदी
पद्धति->पद्धती
पद्मकर->पद्माकार
पद्मकेशर->पद्मकेसर
पद्माकर->पद्माकार
पनु->पनू
पन्नगकेशर->पन्नगकेसर
पन्नगारि->पन्नागारि
परःश्वस्->परःस्वस्
परञ्जन->पराञ्जन
परतन्त्र->परातन्त्र
परपुरुष->परपूरुष
परभृत->पराभृत
परमपुरुष->परमपूरुष
परमर्षि->परमार्षि
परलोकगम->परलोकागम
परशुधर->परशुधार
परश्वध->परस्वध
पराभव->पराभाव
परायति->परायती
परासु->परासू
परासु->पारासु
परि->परी
परि->पाणी
परि->पारि
परिकर->परिकार
परिकूट->पारिकुट
परिक्षित्->परीक्षित्
परिक्षित्->पारिक्षित्
परिक्षित्->पारीक्षित्
परिक्षेपक->पारिक्षेपक
परिखा->पाणिका
परिगत->पाणिगत
परिगृहीत->पाणिगृहीत
परिघात->पाणिगत
परिचय->परिचाय
परिणय->परिरय
परिणय->परीणाय
परिणय->पारिणाय
परिणाम->परीणाम
परिणाय->परिरय
परिणाय->परीणाय
परिणाय->पारिणाय
परिणाह->परीणाह
परिताप->परीताप
परितोष->परीतोष
परिदान->परीधान
परिधान->परीधान
परिधि->परिधी
परिपाक->परीपाक
परिपाटि->परिपाटी
परिपेल->पारिपेल
परिभव->परिभाव
परिभव->परीभाव
परिभ्रमण->परिभ्रामण
परिमर->परीमाण
परिमल->परीमल
परिमाण->परीमाण
परिमित->पाणिमित
परिल->पारिल
परिवर्त्त->परीवर्त्त
परिवर्ह->पारिवर्ह
परिवह->परीवाह
परिवाद->परीवाद
परिवाप->परीवाप
परिवार->परीवार
परिवाह->परीवाह
परिवृत->परीवृत
परिवृत्ति->परिवृत्ती
परिवेत्तृ->परीवेत्तृ
परिवेश->परीवेश
परिव्राजि->परिव्राजी
परिशेष->परीशेष
परिश्रम->परिश्राम
परिषद्->पारिषद्
परिष्कन्द->परिष्कन्ध
परिसर->परिसार
परिसर->परीसर
परिसर्प->परीसर्प
परिसर्य्या->पाणिसर्य्या
परिसारक->पारिसारक
परिस्रव->परिस्राव
परिहार->परीहार
परिहास->परीहास
परीणह्->पारीणः
परीर->पारिण
परु->परू
परुच्छेप->पारुच्छेप
परुद्वार->परूद्वार
परेष्टुका->परैष्टुका
परोक्ष->पारोक्ष
पर्कटि->पर्कटी
पर्जन्य->पार्जन्य
पर्ण->पार्ण
पर्णकार->पर्णाकर
पर्णरुह्->पर्णरूह्
पर्णल->पर्णाल
पर्णवल्क->पार्णवल्क
पर्णशद->पर्णशाद
पर्णस->पर्णाश
पर्णसि->पर्णासि
पर्य्यय->पर्य्याय
पर्व->पार्व
पर्वणिका->पर्वणीका
पर्वतीय->पार्वतीय
पर्शुका->पार्शुका
पर्शुल->पर्शूल
पर्ष->पार्ष
पलद->पालद
पलल->पालाल
पलव->पलाव
पलाद->पालद
पलाल->पालाल
पलाशक->पालशक
पलाशक->पालाशक
पल्य->पाल्य
पल्लविक->पाल्लविक
पल्लि->पल्ली
पल्वल->पाल्वल
पव->पाव
पवनाशनाश->पवनाशनास
पवित->पावित
पवित्र->पावित्र
पवीरव->पावीरव
पश->पास
पशु->पशू
पश्चिमानूपक->पाश्चिमानूपक
पस->पास
पांशन->पांसन
पांशव->पांसव
पांशु->पांसु
पांशुकासीस->पांसुकसीस
पांशुकासीस->पांसुकासीस
पांशुकूल->पांसुकूल
पांशुचत्वर->पांसुचत्वर
पांशुचन्दन->पांसुचन्दन
पांशुचामर->पांसुचामर
पांशुज->पांसुज
पांशुर->पांसुर
पांशुरागिणी->पांसुरागिणी
पांशुराष्ट्र->पांसुराष्ट्र
पांशुल->पांसुल
पाकरु->पाकारु
पाकलि->पाकली
पाञ्चवर्षिक->पाञ्चवार्षिक
पाटन->पाठान
पाटलि->पाटली
पाटलिपुत्र->पाटलीपुत्र
पाटित->पाठित
पाटी->पाठी
पाटुपट->पाटूपट
पाट्य->पाठ्य
पाठन->पाठान
पाणि->पाणी
पाणि->पारि
पाणितल->पाणिताल
पाणितल->पाणीतल
पाण्डुसोपाक->पाण्डुसौपाक
पातक->पाताक
पाति->पाती
पाति->पाथि
पादशस्->पादशाश्
पापपुरुष->पापपूरुष
पामर->पामार
पायिक->पायीक
पारशव->पारसव
पारस->पारास
पारावताङ्घ्रि->पारावताङ्घ्री
पाराशरि->पाराशरी
पाराशरिन्->पारासरिन्
पारिजात->पारीजात
पारिणाह्य->पारीणह्य
पारिपन्थिक->पारिपान्थिक
पारिपाट्य->पारिपाठ्य
पारिश->पारीश
पारुच्छेपि->पारुच्छेपी
पारुष्ण->पारूष्ण
पार्ष्णि->पार्ष्णी
पालल->पालाल
पालि->पाली
पावकि->पावकी
पाश->पास
पाषण्ड->पाषाण्ड
पाषण्डिन्->पाषाण्डिन्
पिच्चा->पिच्छा
पिञ्जन->पिञ्जान
पिटक->पिठक
पिटक->पीठक
पिटक्या->पिटाक्या
पिटाक->पिठक
पिटाक->पीठक
पिड->पिढ
पिड->पीढ
पिण्डल->पिण्डाल
पिण्डस->पिण्डाश
पिण्डालु->पिण्डालू
पित्त->पित्थ
पिप्पिका->पिप्पीका
पिशी->पिसि
पीड->पीढ
पीतशाल->पीतसाल
पीति->पीती
पीति->पीथी
पीतिका->पीथिका
पीतिन्->पीथिन्
पीथि->पीथी
पीलु->पीलू
पुक्कश->पुक्कस
पुच्छटि->पुच्छटी
पुच्छण्डक->पुच्छाण्डक
पुञ्जि->पुञ्जी
पुण्ड्र->पुण्ढ्र
पुण्य->पुर्य
पुण्य->पूर्य
पुण्यगन्ध->पुण्यगान्ध
पुत्->पुथ्
पुत्->पूत्
पुनर्भव->पुनर्भाव
पुनर्वसु->पुनर्वसू
पुरन्ध्रि->पुरन्ध्री
पुरय->पूरय
पुरस्->पुरास्
पुराकृत->पूरकृत
पुरि->पुरी
पुरि->पूरी
पुरितत्->पुरीतत्
पुरु->पुरू
पुरुद->पुरुध
पुरुरवस->पुरूरवस
पुरुषकार->पुरुषाकार
पुरुषदन्तिका->पुरूषदन्तिका
पुरुषाद->पूरुषाद
पुरुहूत->पुरूहूत
पुरोटि->पूरोटि
पुरोडाश्->पुरोडास्
पुल्य->पूल्य
पुषा->पूषा
पुष्कर->पूष्कर
पुष्पप्रचय->पुष्पप्रचाय
पुष्पवती->पुष्पावती
पुष्पशर->पुष्पासार
पुष्पसार->पुष्पासार
पुस->पूस
पूति->पूती
पूतिकरज->पूतीकरज
पूर्णक->पूर्णख
पूर्णककुद्->पूर्णकाकुद्
पूर्णकुट->पूर्णकूट
पूर्णि->पूर्णी
पूर्वचित्ति->पूर्वचित्ती
पूर्वभद्रपदा->पूर्वभाद्रपदा
पूर्वभद्रपदा->पूर्वाभाद्रपदा
पूर्वसर->पूर्वसार
पृक्त->पृक्थ
पृत्->पृथ्
पृषत->पृषात
पृष्टि->पृष्टी
पृष्टि->पृष्ठि
पृष्टि->पृष्ठी
पेट->पेठ
पेटक->पैटक
पेटक->पैटाक
पेटक->पैठक
पेटाक->पैटक
पेटाक->पैटाक
पेटाक->पैठक
पेण->पेर
पेण->पैण
पेयूष->पैयूष
पेशल->पेसल
पेशस्->पेसस्
पेशि->पेशी
पेषणि->पेषणी
पेषि->पेषी
पैङ्गि->पैङ्गी
पोत->पोथ
पोतन->पौतन
पोतिका->पोथिका
पोत्र->पौत्र
पोत्रिन्->पौत्रिन्
पोल->पौल
पोलिका->पौलिका
पौण्ड्र->पौण्ढ्र
पौण्य->पौर्य
पौरगीय->पौरागीय
प्रकर->प्रखर
प्रकार->प्रखर
प्रक्वण->प्रक्वाण
प्रगे->प्रगै
प्रघण->प्रघाण
प्रचय->प्रचाय
प्रचलक->प्रचालक
प्रचलाक->प्रचालक
प्रजनुक->प्रजानुक
प्रजापति->प्रजापती
प्रजिन->प्रजीन
प्रज्ञप्ति->प्रज्ञप्ती
प्रणय->प्रणाय
प्रणयन->प्रणयान
प्रणस->प्रणाश
प्रणिधि->प्रणिधी
प्रतति->प्रतती
प्रतनु->प्रतनू
प्रतर->प्रतार
प्रतिकश->प्रतिकास
प्रतिकाश->प्रतिकास
प्रतिदान->प्रतिधान
प्रतिदिवन्->प्रतिदीवन्
प्रतिधि->प्रतिधी
प्रतिनिधि->प्रतिनिधी
प्रतिफल->प्रतिफाल
प्रतिश्याय->प्रतिस्याय
प्रतिष्ठ->प्रतीष्ट
प्रतिष्ठ->प्रथिष्ट
प्रतिष्ठित->प्रातिष्ठित
प्रतिसीरा->प्रतीसीरा
प्रतिहत->प्रातिहत
प्रतिहार->प्रतीहार
प्रतिहार->प्रातिहर
प्रतिहार->प्रातिहार
प्रतिहास->प्रतीहास
प्रतीकाश->प्रतीकास
प्रतीति->प्रथिति
प्रतुद->प्रातुद
प्रत्यक्ष->प्रात्यक्ष
प्रत्यक्षदर्शन->प्रत्याक्षदर्शन
प्रत्यनीक->प्रत्यानीक
प्रत्यभिज्ञा->प्रत्याभिज्ञा
प्रत्यय->प्रत्याय
प्रत्ययित->प्रत्यायित
प्रत्यासर->प्रत्यासार
प्रथ->प्रात
प्रदव->प्रदाव
प्रदव->प्रधाव
प्रदव्य->प्रदाव्य
प्रदा->प्रादा
प्रदि->प्रदी
प्रदि->प्राधी
प्रदुह्->प्रादुः
प्रदोष->प्रादोष
प्रद्वार->प्राध्वर
प्रधा->प्रादा
प्रधि->प्राधी
प्रधी->प्राधी
प्रपतन->प्रपातन
प्रपथ->प्रपाथ
प्रपद->प्रपाद
प्रपात->प्रपाथ
प्रबन्ध->प्राबन्ध
प्रबालिक->प्राबालिक
प्रबोध->प्रभोद
प्रबोध->प्राबोध
प्रबोधन->प्रभोदन
प्रभा->प्राबा
प्रभावत्->प्रभावात्
प्रभु->प्रभू
प्रभृति->प्राभृती
प्रमति->प्रमती
प्रमति->प्रमथि
प्रमति->प्रमाथी
प्रमति->प्रामति
प्रमथित->प्रमाथित
प्रमय->प्रमाय
प्रमयु->प्रमायु
प्रमाण->प्रमार
प्रमिति->प्रमीति
प्रमोद->प्रामोद
प्रयस्->प्रायश्
प्रयाम->प्रायाम
प्रलपन->प्रलापन
प्रलम्ब->प्रालंब
प्रलम्भ->प्रालंब
प्रवक->प्रवाक
प्रवचन->प्रवाचन
प्रवचन->प्रावचन
प्रवण->प्रवाण
प्रवर->प्रवाण
प्रवर्ग->प्रावर्ग
प्रवह्लि->प्रवह्ली
प्रवाहिका->प्रवाहीका
प्रवाही->प्रावहि
प्रवृत्->प्रावृत्
प्रवेणि->प्रवेणी
प्रव्रजन->प्रव्राजन
प्रव्रजित->प्रव्राजित
प्रशम->प्रशाम
प्रशस्त->प्रशास्त
प्रशस्य->प्रशास्य
प्रशान्->प्रसन्
प्रश्न->प्रस्न
प्रश्नि->प्रश्नी
प्रश्लिष्ट->प्राश्लिष्ट
प्रष्टि->प्रष्ठी
प्रष्ठ->प्राष्ट
प्रष्ठ->प्राष्ठ
प्रस->प्राश
प्रसङ्ग->प्रसङ्घ
प्रसर->प्रसार
प्रसवितृ->प्रसवीतृ
प्रसव्य->प्राशव्य
प्रसह->प्रसाह
प्रसह->प्रासह
प्रसह->प्रासाह
प्रसादना->प्रसाधना
प्रसेव->प्रासेव
प्रस्कण्व->प्रास्कण्व
प्रस्तीत->प्रस्थित
प्रस्तुत->प्रस्तूत
प्रस्थ->प्रास्त
प्रस्रवण->प्राश्रवण
प्रस्रवण->प्रास्रवण
प्रस्वन->प्रस्वान
प्रहर->प्रहाण
प्रहाणि->प्रहारि
प्रहाणि->प्राहणि
प्रहुत->प्राहूत
प्रह्राद->प्राह्राद
प्रह्वलीका->प्रह्वालिका
प्राक्फल्गुनी->प्राक्फाल्गुनी
प्राच्->प्राछ्
प्राञ्जलि->प्राञ्जली
प्राण्->प्रार्
प्राणद->प्राणाद
प्रातिपदिक->प्रातिपादिक
प्रातिपीय->प्रातीपीय
प्रातिपेय->प्रातीपेय
प्रान्तर->प्रान्तार
प्रायोपविष्ट->प्रायोपविष्ठ
प्राशन->प्रासन
प्राशु->प्राशू
प्रियक->प्रियाक
प्रियजन->प्रियाजन
प्रीति->प्रीती
प्रु->प्रू
प्रेणि->प्रेरी
प्रेमबन्ध->प्रेमाबन्ध
प्रेष्य->प्रैष्य
प्रोक्त->प्रौक्त
प्रोढ->प्रौढ
प्रोष्ठ->प्रौष्ठ
प्रोष्ठपदा->प्रौष्ठपदा
प्रोह->प्रौह
प्रोह्यपदि->प्रोह्यपादि
प्लक्षप्रस्रवण->प्लक्षप्रास्रवण
प्लव->प्लाव
प्लिह->प्लीह
प्लिहन्->प्लीहन्
प्लीहशत्रु->प्लीहाशत्रु
फट्->फाट्
फणकर->फणाकर
फणधर->फणाधर
फण्ड->फाण्ड
फलकेशर->फलकेसर
फलग्रहि->फलग्राही
फलचमस->फालचमस
फलभोग->फलाभोग
फलि->फालि
फलि->फाली
फलिका->फालिका
फलित->फालित
फली->फालि
फली->फाली
फलेग्रहि->फलेग्राहि
फल्गु->फल्गू
फल्गुनी->फाल्गुनि
फल्गुनी->फाल्गुनी
फाणि->फारि
फाणि->फारी
फुत्->फूत्
फुत्कर->फूत्कार
फुत्कार->फूत्कार
फेलि->फेली
बकुर->बाकुर
बडवाग्नि->बाडवाग्नि
बण->बार
बदरी->बादरि
बध्य->बाध्य
बध्योग->बाध्योग
बन्धन->भन्दन
बन्धु->बन्धू
बन्धुक->बान्धुक
बन्धुक->भन्धुक
बन्धूक->बान्धुक
बन्धूक->भन्धुक
बर->बार
बर्बणा->बर्बरा
बर्बणा->भर्भरा
बर्ह->बार्ह
बलक्ष->बलाक्ष
बलज->बालज
बलदेव->बालदेव
बलल->बलाल
बलहन्->बालहन्
बलि->बली
बलि->बाली
बलिन्->बालिन्
बलिन->बलीन
बलिमुख->बलीमुख
बलीक->बालिक
बल्हि->बाल्हि
बव->बाव
बहु->बाहू
बहुकण्टक->बाहुकण्टक
बहुकर->बहुकार
बहुकर->बाहुकर
बहुधार->बहूदर
बहुपुत्र->बाहुपुत्र
बहुफल->बाहुफल
बहुमल->बहुमाल
बहुवीर्य्य->बाहुवीर्य्य
बहुशाल->बाहुशाल
बाड->बाढ
बाण->बार
बालतन्त्र->बालातन्त्र
बालायनि->बालायनी
बालि->बाली
बाल्हिक->बाल्हीक
बाहु->बाहू
बिटक->बिठक
बिटक->बीटक
बिस->बीश
बुक्कन्->बूक्कन्
बुट->बूट
बुष->बूष
बोधकर->बोधकार
ब्रध्नश्व->ब्रध्नाश्व
ब्रह्मज्ञ->ब्रह्मज्य
ब्रह्मदण्ड->ब्राह्मदण्ड
ब्रह्मन्->ब्राह्मन्
ब्रह्मपुराण->ब्राह्मपुराण
ब्रह्मबन्धु->ब्रह्मबन्धू
ब्रह्ममण्डूकी->ब्रह्ममाण्डूकी
ब्रह्मयोनि->ब्रह्मयोनी
ब्रह्मवास->ब्रह्मावास
ब्रह्मवेदि->ब्रह्मवेदी
ब्रह्मसिद्धान्त->ब्राह्मसिद्धान्त
ब्रह्मस्व->ब्रह्मास्व
ब्रह्माणी->ब्राह्मणि
ब्रह्माणी->ब्राह्माणी
ब्रह्माहुति->ब्रह्माहूति
ब्रह्मी->ब्राह्मि
ब्रह्मी->ब्राह्मी
ब्राह्मणिक->ब्राह्मणीक
ब्राह्मणी->ब्राह्माणी
भक्ति->भक्ती
भगण->भागण
भगदा->भागदा
भगदा->भागधा
भगदेव->भगदैव
भगनन्दा->भगानन्दा
भगल->भागल
भगाधान->भागधान
भगाल->भागल
भङ्गि->भङ्गी
भण्डि->भण्डी
भण्डुक->भण्डूक
भद्रकार->भद्राकर
भद्रकार->भद्राकार
भद्रोदनी->भद्रौदनी
भरत->भरथ
भरिमन्->भरीमन्
भरुज->भरूज
भरुटक->भरूटक
भल्लुक->भल्लूक
भवन्ति->भवन्ती
भागुरि->भागुरी
भाण्डि->भाण्डी
भारय->भाराय
भारवि->भारवी
भारि->भारी
भालुक->भालूक
भास्कर->भास्खर
भिद->भीद
भिदा->भीदा
भीति->भीती
भुजगभोजिन्->भुजगाभोजिन्
भुजज्या->भूजज्या
भुजमध्य->भुजामध्य
भुणिक->भूरिक
भुशुण्डी->भूशुण्डी
भूकश्यप->भूकाश्यप
भूतिक->भूतीक
भूपाल->भूफल
भूमिकदम्ब->भूमीकदम्ब
भूमिजम्बु->भूमिजम्बू
भूमिपति->भूमीपति
भूमिरुह->भूमीरुह
भूरि->भूरी
भूर्जकण्टक->भूर्जकण्ठक
भृकुटि->भृकुटी
भृङ्गरिट->भृङ्गरीट
भृङ्गरिट->भृङ्गारीट
भृङ्गारि->भृङ्गारी
भृत->भृथ
भृति->भृती
भृष्टि->भृष्टी
भेरि->भेरी
भोगक->भौगक
भोगवती->भोगावती
भोजकट->भौजकट
भोज्य->भौज्य
भोट->भौट
भोलि->भौलि
भोलि->भौली
भौरिकि->भौरिकी
भ्रंश->भ्रंस
भ्रकुटि->भ्रकुटी
भ्रजस्->भ्राजस्
भ्रमण->भ्रामण
भ्रमणी->भ्रामणी
भ्रमणी->भ्रामरी
भ्रमर->भ्रामण
भ्रमरक->भ्रामरक
भ्रमरी->भ्रामणी
भ्रमरी->भ्रामरी
भ्रश->भ्राश
भ्रातृश्वशुर->भ्रातृश्वसुर
मकुष्टक->मकुष्ठक
मक्षिका->मक्षीका
मक्षु->मक्षू
मघवन्->मघवान्
मङ्कुर->मङ्खुण
मचर्चिका->मचर्छिका
मज्जन->मज्जान
मञ्जरि->मञ्जरी
मञ्जि->मञ्जी
मञ्जु->मञ्जू
मटची->मठची
मणि->मणी
मणिव->मणीव
मणिसर->मणिसार
मति->मती
मति->मथि
मत्य->मथ्य
मत्र->मथ्र
मथुरा->मथूरा
मदि->मदी
मद्यपाशन->मद्यपासन
मधुकर->मधुकार
मधुपालिका->मधुफलिका
मधुमत्->मधुमथ्
मधुयष्टि->मधुयष्टी
मधुलिका->मधूलिका
मनःशिला->मनःसिला
मनन->मनान
मन्तु->मन्थु
मन्द->मन्ध
मन्दिर->मन्दीर
मरकत->मारकत
मरण->मरार
मरिच->मरीच
मरिच->मारिच
मरीचि->मरीची
मरीचि->मरीछि
मरीचि->मारीचि
मरीचि->मारीची
मरु->मरू
मरुत्पाल->मरुत्फल
मरुभू->मरूभू
मरुव->मरूव
मर्क->मार्क
मर्कट->मार्कट
मर्कटी->मार्कटि
मर्कर->मार्कर
मलय->मालय
मलाका->मालका
मलाका->मालाका
मल्ल->माल्ल
मल्लि->मल्ली
मशक->मशाक
मशक->मसक
मशक->मासक
मसिजल->मसीजल
मसुर->मसूर
मसुर->मासूर
मसूरी->मासुरि
मसूरी->मासुरी
महा->माहा
महाकुल->महाकूल
महाकुलीन->माहाकुलीन
महादान->महाधान
महाधन->महाधान
महानन्दि->महानन्दी
महानस->महानास
महानस->माहानस
महानाद->माहानद
महापथ->महापात
महापुरुष->महापूरुष
महाप्राण->माहाप्राण
महामेद->महामेध
महारजन->माहारजन
महारात्रि->महारात्री
महाराष्ट्र->माहाराष्ट्र
महावराह->महावाराह
महाव्रत->महाव्रात
महाशीता->महासिता
महि->मही
महिमन्->महिमान्
महिर->माहिर
महिला->महीला
महेश->माहेश
महौषधि->महौषधी
माक्षिक->माक्षीक
माक्षिकशर्करा->माक्षिकाशर्करा
माक्षिकशर्करा->माक्षीकशर्करा
माणव->मारव
मातरपितृ->मातरापितृ
मातलि->मातली
मातलि->माताली
मातृबन्धु->मातृबन्धू
माद्री->माध्रि
मानस->मानास
मारि->मारी
मार्गण->मार्गार
मार्द्दव->मार्द्धव
मार्ष्टि->मार्ष्ठि
मित->मीत
मिथ->मीत
मिशि->मिशी
मिशि->मिसि
मिशि->मिसी
मिश्र->मिस्र
मुकुष्टक->मुकुष्ठक
मुक्ताप्रसू->मुक्ताप्रासू
मुखदूषण->मूखदूषण
मुखस्राव->मुखास्राव
मुट->मूट
मुठ->मूट
मुण->मूर
मुद्गष्ट->मुद्गष्ठ
मुनि->मुनी
मुर->मूर
मुशटी->मुसटी
मुशली->मुसली
मुष्टि->मुष्टी
मूषिक->मूषीक
मृगनाभि->मृगनाभी
मृगेर्वारु->मृगैर्वारु
मृद्->मृध्
मृदु->मृदू
मृदु->मृधु
मेकल->मेखल
मेकलकन्यका->मेखलकन्यका
मेघ->मैघ
मेट->मेठ
मेथि->मेथी
मेदज->मेधज
मेनाद->मैनाद
मेषाक्षिकुसुम->मेषाक्षीकुसुम
मोक्ष->मौक्ष
मोच->मौच
मोद->मौद
मोदक->मोदाक
मोदक->मौदक
मोरट->मौरट
मौलि->मौली
यक्ष->याक्ष
यज->याज
यजमान->याजमान
यजि->याजि
यज्ञ->यज्य
यज्ञ->याज्ञ
यज्ञिय->याज्ञिय
यज्ञिय->याज्ञीय
यज्ञीय->याज्ञिय
यज्ञीय->याज्ञीय
यत->यथ
यत->यात
यत->याथ
यति->यती
यति->याति
यतुका->यतूका
यत्र->यात्र
यथा->याता
यथा->याथा
यद्->याद्
यदि->यदी
यदु->यादु
यभ->याभ
यमक->यामक
यमकोटि->यमकोटी
यमन->यामन
यमुना->यामुना
यवन->यवान
यवनिका->यवानिका
यवनी->यावानी
यवस->यावस
यवस->यावास
यवानी->यावानी
यवास->यावस
यवास->यावास
यव्य->याव्य
यष्टि->यष्टी
यष्टि->याष्टि
यष्टीक->याष्टिक
यस्क->यास्क
यामुनेष्टक->यामुनेष्ठक
यु->यू
युतक->यूथक
युवखलति->युवखलती
योग->यौग
योगरङ्ग->योगारङ्ग
योत्र->यौत्र
योध->यौध
योनि->योनी
रक्तसन्ध्यक->रक्तसन्ध्याक
रक्तातिसार->रक्तातीसार
रक्षणि->रक्षणी
रङ्गजीवक->रङ्गाजीवक
रजनि->रजनी
रज्जु->रज्जू
रति->रती
रत्नवती->रत्नावती
रथकर->रथकार
रथकर->रथाकार
रथाङ्गपाणि->रथाङ्गपाणी
रथ्य->राथ्य
रमण->रमाण
रमल->रामल
रमापति->रामपति
रम्या->राम्या
रय->राय
रवण->रवाण
रसन->रासन
रसायन->रासायन
रसिक->राशिक
रस्य->रास्य
रह->राह
राजकशेरु->राजकसेरु
राजधानी->राजादनी
राजन्->राजान्
राजस्व->राजाश्व
राजि->राजी
रात्रि->रात्री
रात्रिचर->रात्रिचार
रामगिरि->रामगिरी
रामच्छर्दनक->रामाच्छर्दनक
रावणि->रावणी
राशि->राशी
राष्ट्रिय->राष्ट्रीय
रीण->रीर
रीति->रीती
रु->रू
रुचक->रूचक
रुचि->रुची
रुत->रुथ
रेक->रेख
रेक->रैख
रेतस->रैतस
रेब->रैभ
रेभ->रैभ
रेवती->रैवती
रोड->रौड
रोध->रौध
रोमक->रौमक
रोमन्थ->रोमान्त
रोमावलि->रोमावली
रोषण->रोषाण
रोहि->रोही
रोहि->रौही
रोहिणी->रौहिणि
रोहित->रौहित
रोहित->रौहीत
लकुच->लाकुच
लक्ष->लाक्ष
लक्षण->लाक्षण
लग->लाग
लघ->लाग
लघु->लघू
लटक->लाटक
लत->लात
लप->लाप
लब->लाब
लभ->लाब
लभ्य->लाभ्य
लम्ब->लम्भ
लम्बन->लम्भन
लम्बा->लम्भा
लय->लाय
लल->लाल
ललाट->लालाट
ललित->ललिथ
ललित->लालित
लवली->लावली
लश->लास
लस->लास
लसिका->लसीका
लहरि->लहरी
लिक्षा->लीक्षा
लिपि->लिपी
लिपिकर->लिपिकार
लिबि->लिबी
लुण्ट->लुण्ठ
लुण्टक->लुण्ठाक
लुण्टाक->लुण्ठाक
लुण्ठक->लुण्ठाक
लुथ->लूत
लुह->लूह
लेख->लैख
लैङ्गिक->लैङ्गीक
लोट->लोठ
लोम->लौम
लोमश->लोमाश
लोमशातन->लोमसातन
लोष्ट->लोष्ठ
लोहकार->लोहाकर
लोहकार->लौहकार
लोहज->लोहाज
लोहित->लौहित
लोहितक->लौहितक
वंश->वांश
वकुल->वकूल
वकुल->वाकुल
वक्र->वाक्र
वङ्क->वाङ्क
वङ्ग->वङ्घ
वङ्ग->वाङ्ग
वङ्गारि->वाङ्गारि
वचस्->वाचस्
वचसांपति->वाचसांपति
वचसांपति->वाचसाम्पति
वचा->वाचा
वज्रधर->वज्रधार
वञ्चक->वाञ्छक
वञ्चक->वाञ्छाक
वञ्चन->वाञ्छन
वञ्चुक->वञ्चूक
वटक->वाटक
वटर->वाटर
वटी->वठि
वटी->वाटि
वटी->वाटी
वटु->वाटु
वठर->वाटर
वडभि->वडभी
वत्->वात्
वतण्ड->वातण्ड
वत्स->वात्स
वत्सर->वत्सार
वत्सर->वथ्सर
वद->वध
वदन->वाधन
वदान्य->वादान्य
वदाल->वादाल
वदावद->वधावध
वदावद->वादवाद
वधू->वाधु
वधू->वाधू
वनज->वनाज
वनमक्षिका->वनमाक्षिका
वनि->वनी
वन्दन->वान्दन
वन्दा->वन्धा
वन्दि->वन्दी
वन्द्य->वन्ध्य
वन्य->वान्य
वपन->वापन
वपनी->वापनि
वप्रि->वप्री
वमि->वमी
वयुन->वायुन
वरण->वरर
वरत्रा->वारत्रा
वरम्बरा->वराम्बरा
वरल->वराल
वरा->वारा
वरादन->वारधान
वरालिका->वारालिका
वराशि->वरासी
वरासन->वाणासन
वरासन->वारासन
वरासि->वरासी
वराहकन्द->वाराहकन्द
वराही->वाराहि
वरी->वाणी
वरी->वारी
वरुट->वारुठ
वरुड->वारुड
वरुड->वारूढ
वरुणानी->वारुणानी
वर्ग->वर्घ
वर्ण->वार्ण
वर्णसि->वार्राशि
वर्त्ति->वर्त्ती
वर्द्ध->वार्द्ध
वर्द्धकि->वर्द्धकी
वर्ध्र->वार्ध्र
वर्पस्->वर्फस्
वर्य्य->वार्य्य
वर्वणा->वार्वणा
वर्वर->वार्वर
वर्ष->वार्ष
वर्षकरी->वर्षकारी
वर्षुक->वार्षुक
वर्ह->वार्ह
वर्हिण->वार्हिण
वल->वाल
वलन->वलान
वलन->वालन
वलभि->वलभी
वलाक->वालक
वलाक->वालाक
वलि->वली
वलि->वालि
वलि->वाली
वलीक->वालिक
वलूक->वालुक
वलूक->वालूक
वल्कल->वाल्कल
वल्मिकि->वल्मीकि
वल्मिकि->वाल्मीकि
वल्युल->वल्यूल
वल्लर->वल्लार
वल्लरि->वल्लरी
वल्लरि->वल्लारी
वल्लि->वल्ली
वव->वाव
वशिक->वसिक
वशिन्->वसिन्
वश्य->वस्य
वसति->वसती
वसति->वसाति
वसन->वसान
वसि->वसी
वसुक->वसूक
वसुदेव->वसुदैव
वसुमती->वसूमती
वस्ति->वस्ती
वहति->वहती
वाग्यम->वाग्याम
वाच्->वाछ्
वाचनिक->वाचनीक
वाट्या->वाठ्या
वाणि->वाणी
वाणि->वारी
वातापि->वातापी
वाति->वाती
वातिक->वातीक
वातुलि->वातूली
वादन->वाधन
वादल->वादाल
वादि->वादी
वादिन्->वाधिन्
वापि->वापी
वारवाणि->वारवाणी
वारि->वारी
वार्द्धुषि->वार्द्धुषी
वाल्मिकि->वाल्मीकि
वाशा->वासा
वाशिता->वासिता
वाशिष्ठ->वासिष्ट
वाशिष्ठ->वासिष्ठ
वाश्र->वास्र
वासत->वासात
वासि->वासी
वासुकि->वासुकी
वाह्लिक->वाह्लीक
विकश्वर->विकस्वर
विकसित->विकाशित
विकसित->विकासित
विकाश->विकास
विकाशिन्->विकासिन्
विकिरण->विकीरण
विकृति->विकृती
विक्रम->विक्राम
विक्रय->विक्राय
विक्रयिक->विक्रायिक
विगम->विगाम
विगान->विघन
विग्रह->विग्राह
विच->विछ
विचि->विची
विजन->विजान
विज्जुलिका->विज्जूलिका
विज्ञ->विज्य
विट->विठ
विटङ्क->विठङ्क
वितर्दि->वितर्दी
वितल->विताल
विद्->विध्
विदर->विधर
विदर->विधार
विदा->विधा
विदार->विधर
विदार->विधार
विदारक->विधारक
विदारण->विधरण
विदारण->विधारण
विदित->विदिथ
विदु->विधू
विद्यमान->विध्यमान
विद्याधर->विद्याधार
विद्र->विध्र
विद्रव->विद्राव
विद्वस्->विध्वस्
विधि->विधी
विधु->विधू
विधुनन->विधूनन
विनत->विनाथ
विनशन->विनाशन
विनाश->विनास
विप->विफ
विपणि->विपणी
विपणि->विपरी
विपथ->विपात
विपर्य्यय->विपर्य्याय
विपल->विपाल
विप्रतिसार->विप्रतीसार
विभु->विभू
विमत->विमाथ
विमनस्->विमानस्
विमर्द->विमर्ध
वियम->वियाम
विरजस्->विरजास्
विरत->विरथ
विरत->विरात
विरति->विरथी
विराधन->विराधान
विलय->विलाय
विवर->विवार
विवश->विवाश
विवश->विवास
विशद->विशाद
विशस्तृ->विशास्तृ
विशाकर->विशाकार
विश्रणन->विश्राणन
विश्रम->विश्राम
विश्वकद्रु->विश्वकद्रू
विश्वसृज्->विस्वसृज्
विश्वाची->विस्वची
विष्->वीष्
विषधर->विषधार
विषय->विषाय
विषयिन्->विषायिन्
विषु->विषू
विषुवत्->विषूवत्
विष्टरश्रवस्->विष्टरस्रवस्
विष्टरुहा->विष्टारुहा
विष्टि->विष्टी
विष्णुपद->विष्णुपाद
विस->वीश
विस->वीस
विसर्प->वीसर्प
विहर->विहाण
वीचि->वीची
वीटि->वीटी
वीणावाद->वीरवाद
वीतशोक->वीताशोक
वीति->वीथी
वीथि->वीथी
वृद्धि->वृद्धी
वृश्चिक->वृश्चीक
वृषण->वृषाण
वृषणश्व->वृषणाश्व
वृष्टि->वृष्टी
वृष्णि->वृष्णी
वेगसर->वेगसार
वेण->वैण
वेणि->वेणी
वेणि->वेरि
वेणि->वैणि
वेणि->वैरि
वेणि->वैरी
वेणीर->वैरिण
वेणु->वैणु
वेतन->वेतान
वेतन->वैतान
वेताल->वैताल
वेत्र->वैत्र
वेत्रकीय->वैत्रकीय
वेत्रवती->वेत्रावती
वेत्रासुर->वैत्रासुर
वेद->वैद
वेदन->वेधन
वेदि->वेदी
वेदि->वेधी
वेदि->वैदि
वेदि->वैदी
वेदिन्->वेधिन्
वेध->वैद
वेम->वैम
वेर->वैण
वेल->वैल
वेश->वैश
वेशन्त->वेशान्त
वेशन्त->वैशन्त
वेस->वैश
वेसवार->वैशवण
वेहार->वैहार
वैणिक->वैरिक
वैतरणि->वैतरणी
वैदिक->वैधिक
वैदूर्य्य->वैधुर्य्य
वैरकर->वैरकार
वैशाख->वैसाख
वैशिक->वैशिख
वोड्र->वौड्र
व्यक्ति->व्यक्ती
व्यच->व्यछ
व्यतिकर->व्यतीकार
व्यतिहार->व्यतीहार
व्यतीत->व्यथित
व्यभिचार->व्यभीचार
व्यवहारपद->व्यवहारपाद
व्याधि->व्याधी
व्याधुत->व्याधूत
व्यापृत->व्यापृथ
व्रज->व्राज
व्रण->व्राण
व्रतति->व्रतती
व्रीहि->व्रीही
शकलिन्->शाकलिन्
शकार->शाकार
शकारि->शाकरी
शकारि->शाकारी
शकुनि->शकुनी
शकुनि->शाकुनि
शकुल->शाकुल
शक्कर->शाक्कर
शक्ति->शक्ती
शक्य->शाख्य
शक्राणी->शक्रारि
शक्राशन->शक्रासन
शक्रि->शाक्री
शङ्क->शाङ्क
शङ्क->शाङ्ख
शङ्कर->शङ्खण
शङ्कर->शाङ्कर
शङ्का->शङ्खा
शङ्ख->शाङ्क
शङ्ख->शाङ्ख
शङ्खधरा->शङ्खधारा
शचि->शची
शचि->शाचि
शट->शाठ
शटि->शटी
शटि->शठी
शटि->शाटि
शटि->शाटी
शटि->शाठी
शठ->शाठ
शणपर्णी->शरपर्णी
शणिका->शरिका
शणिका->शारिका
शण्ड->शाण्ड
शण्डिल->शाण्डिल
शण्ढ->शाण्ड
शतक->शातक
शतद्रु->शतद्रू
शतपत्त्र->शातपत्त्र
शतपथ->शातपत
शतपथ->शातपथ
शतपथिक->शातपथिक
शतमख->शातमख
शनकावलि->शनकावली
शनि->शानि
शनैश्चर->शानैश्चर
शब्द->शाब्द
शब्दित->शाब्दित
शम->शाम
शमन->शामन
शमि->शमी
शमीक->शामिक
शम्ब->शाम्ब
शम्बर->शंभर
शम्बर->शम्भर
शम्बर->शाम्बर
शम्बर->शाम्भर
शम्बर->शांभर
शम्बरी->शांबरी
शम्बु->शम्बू
शम्बु->शंभु
शम्बु->शंभू
शम्बु->शम्भू
शम्बु->शाम्बु
शम्बु->शांबु
शम्भ->शाम्ब
शम्भु->शंभू
शम्भु->शम्भू
शम्भु->शाम्बु
शम्भु->शांबु
शय->शाय
शयन->शयान
शयन->शायन
शयित->शायित
शरण->शारण
शरणि->शरणी
शरणि->शरारि
शरणि->शरारी
शरधि->शारदी
शरभ->शारभ
शरयु->शरयू
शराव->शाराव
शरिमन्->शरीमन्
शरी->शाणी
शरी->शारी
शरीरक->शारीरक
शरु->शारु
शर्करक->शार्करक
शर्करिक->शार्करिक
शर्व->शार्व
शर्वरी->शार्वरी
शर्वाणी->शार्वरी
शलक->शलाक
शलक->शालक
शलक->शालाक
शलभ->शालभ
शलालुक->शालालुक
शल्भ->शाल्भ
शल्मलि->शल्मली
शल्मलि->शाल्मली
शश->शाश
शशक->शाशक
शशक->शासक
शशबिन्दु->शाशबिन्दु
शशाण्डुलि->शशाण्डुली
शशिन्->शासिन्
शश्वत्->शाश्वत्
शस->शाश
शस्त्री->शास्त्री
शाकाङ्ग->शाखाङ्ग
शाक्य->शाख्य
शाट->शाठ
शाणि->शाणी
शाणि->शारी
शाणित->शारित
शाम्बुक->शाम्बूक
शारि->शारी
शालिपिष्ट->शालिपिष्ठ
शालुक->शालूक
शाल्मलि->शाल्मली
शास्त्रचारण->शास्त्राचरण
शिक्षा->शीक्षा
शिक्षाकर->शिक्षाकार
शिखण्डक->शिखाण्डक
शिखरिन्->शीकरिन्
शिखाधर->शिखाधार
शितशूक->शितसूक
शिति->शिती
शिलाभव->शिलाभाव
शिलि->शिली
शिवप्रिय->शिवाप्रिय
शिवरात्रि->शिवरात्री
शिशुक->शिसुक
शीतबला->शीताबला
शुकतरु->शूकतरु
शुचि->शुची
शुचि->शूचि
शुण्डी->शुण्ढि
शुन->शून
शुनकचञ्चुका->शुनकचञ्चूका
शुन्ध्यु->शुन्ध्यू
शुभ्रि->शुभ्री
शूकर->शूकार
शूकशिम्बि->शूकशिम्बी
शूर्मि->शूर्मी
शूलिक->शूलीक
शृधु->शृधू
शेफालि->शेफाली
शेष->शैष
शैवलिनी->शैवालिनी
शो->शौ
शोण->शौर
शौण्डिक->शौण्डीक
श्यामलता->श्यामालता
श्येत->श्यैत
श्येन->श्यैन
श्रत्->श्रथ्
श्रथ->श्रात
श्रमण->श्रामण
श्रय->श्राय
श्रव->श्राव
श्रवणद्वादशी->श्रावणद्वादशी
श्रित->श्रीत
श्रीकर->श्रीकार
श्रु->श्रू
श्रुतदेवी->श्रुतादेवी
श्रुति->श्रुती
श्रेणि->श्रेणी
श्रोणि->श्रोणी
श्रोणिसूत्र->श्रोणीसूत्र
श्रोत्रिय->श्रोत्रीय
श्लक->श्लख
श्लग->श्लघ
श्वदंष्ट्रा->श्वादंष्ट्रा
श्वफल्क->श्वाफल्क
श्वयथु->श्वयातु
श्वशुर->श्वाशुर
श्वसन->श्वसान
श्वसनाशन->श्वसनासन
श्वसित->श्वासित
श्वेत->श्वैत
श्वेत्य->श्वैत्य
षड्ग्रन्थि->षड्ग्रन्थी
षण्ड->षाण्ड
षण्ढ->षाण्ड
षण्मुख->षाण्मुख
षद->षध
षष्टि->षष्टी
षष्टिक->षाष्टिक
षष्टिक->षाष्टीक
षष्टिक->षाष्ठिक
षष्टिमत्त->षष्ठिमत्त
षष्टिहायन->षष्ठिहायन
षष्ठ->षाष्ठ
षात्वणत्विक->षात्वणात्विक
षोडशभुजा->षोडशभूजा
ष्टु->ष्ठु
संयत->संयात
संयम->संयाम
संवत्->संवात्
संवदन->संवादन
संविद्->संविध्
संविदा->संविधा
संशप्तक->संसप्तक
संशरण->संसारण
संशित->संशीत
संश्रव->संश्राव
संसद्->संसाध्
संसरण->संसारण
संसृष्टि->संसृष्टी
संस्तर->संस्तार
संहत->संहात
सकल->सकाल
सक्त->सक्थ
सक्थि->सक्थी
सङ्करी->सङ्कारी
सङ्क्रम->सङ्क्राम
सङ्गत->सङ्गथ
सङ्गति->सङ्घति
सचि->सची
सञ्चय->सञ्चाय
सञ्चर->सञ्चार
सटि->सटी
सटि->सठि
सटि->सठी
सत्त्रशाला->सत्त्रसाला
सत्त्रि->सत्त्री
सत्यरत->सत्यरथ
सदन->सदान
सदन->सधन
सधि->सधी
सनक->सनख
सनत्कुमार->सनात्कुमार
सनि->सनी
सन्दानिका->सन्धानिका
सन्दानित->सन्धानित
सन्दानिनी->सन्धानिनी
सन्निपतित->सन्निपातित
सप्ततितम->सप्तातितम
सप्तशिरा->सप्तसिरा
सभापति->सभापती
समज्ञा->समाज्ञा
समज्या->समाज्ञा
समन्त->समान्त
समपद->समपाद
समय->समाय
समया->समाया
समर->समाण
समर्थ->समार्थ
समवकार->समवाकार
समवाय->समावाय
समसन->समासन
समस्त->समास्थ
समस्थ->समास्थ
समस्या->समास्या
समादान->समाधान
समालम्बिन्->समालम्भिन्
समासङ्ग->समासाङ्ग
समिध->समीद
समिन्धन->समिन्धान
समीक->सामिक
समीप->सामीप
समीरण->सामीरण
समुच्चर->समुच्चार
समुच्छ्रय->समुच्छ्राय
समुच्छ्वसित->समुच्छ्वासित
समुदय->समुदाय
समुद्ग->सामुद्ग
समुद्यत->समुद्यात
समुद्रिय->समुद्रीय
समुद्वह->समुद्वाह
समृद्धि->समृद्धी
सम्पराय->सांपराय
सम्पराय->साम्पराय
सम्परायिक->सांपरायिक
सम्प्रति->सम्प्रती
सम्प्रति->संप्रती
सम्प्रदान->सम्प्रधान
सम्बर->संभर
सम्बर->सम्भर
सम्बर->संभार
सम्बल->सम्भल
सम्बल->संभल
सम्बल->संभाल
सम्भव->संभाव
सम्भव्य->सम्भाव्य
सम्भव्य->संभाव्य
सम्भूति->सम्भूती
सम्मद->संमाद
सम्मद->सम्माद
सरङ्ग->सराङ्घ
सरट->सराट
सरणि->सरणी
सरणि->सरारी
सरण्यु->सरण्यू
सरयु->सरयू
सरल->सराल
सरसिज->सरसीज
सरि->सरी
सरिमन्->सरीमन्
सर्जि->सर्जी
सर्जिक्षार->सर्जीक्षार
सर्वदा->सर्वधा
सर्वमय->सर्वमाय
सर्वरस->सर्वरास
सर्वलोह->सर्वलौह
सर्वसह->सर्वसाह
सर्वौषधि->सर्वौषधी
सलिल->सलील
सविकाश->सविकास
सहपांशुकिल->सहपांसुकिल
सहस्य->सहास्य
सागरनेमि->सागरनेमी
साङ्गतिक->साङ्घातिक
साचि->साची
सादनी->साधनी
सादि->सादी
सादिन्->साधिन्
साधन->साधान
सानसि->सानसी
सामन्त->सामान्त
सामयिक->सामायिक
साम्बर->साम्भर
साम्बर->सांभर
सारणि->सारणी
सारमिति->सारमीति
सारव->साराव
सारस->सारास
सारि->सारी
सिंहकेशर->सिंहकेसर
सिंहतल->सिंहताल
सित->सीत
सितशूरण->सितसूरण
सिति->सिती
सितिवार->सितीवार
सिध्य->सीद्य
सिध्र->सीध्र
सिन्दुक->सिन्धुक
सिन्दुवार->सिन्धुवार
सिम->सीम
सीमन्त->सीमान्त
सीलन्द->सीलन्ध
सुकल->सुकाल
सुकालुका->सुखालुका
सुकृति->सुकृती
सुखजात->सुखाजात
सुगन्धि->सुगन्धी
सुतक->सूतक
सुतनु->सुतनू
सुतपस्->सूतपस्
सुतल->सुताल
सुदामन्->सुधामन्
सुदामन्->सूदामन्
सुदाय->सुधय
सुदाय->सुधाय
सुदि->सुधि
सुदि->सूदि
सुदि->सूदी
सुदूर->सुधुर
सुधी->सूदि
सुधी->सूदी
सुनार->सूनर
सुपर्वन्->सुपर्वान्
सुप्रसरा->सुप्रसारा
सुफल->सुफाल
सुभग->सुभाग
सुमति->सुमती
सुरत->सूरथ
सुरता->सुरथा
सुरता->सूरता
सुरथ->सूरथ
सुरनन्दा->सुरानन्दा
सुरप्रिय->सुराप्रिय
सुरभि->सुरभी
सुरभिपत्त्रा->सुरभीपत्त्रा
सुरभिस्रवा->सुरभीस्रवा
सुरसाष्ट->सुरसाष्ठ
सुराकर->सुराकार
सुरापगा->सूरापगा
सुरोद->सुरोध
सुलभ->सुलाभ
सुवचस्->सुवाचस्
सुवल्लि->सुवल्ली
सुविद->सुविध
सुशवी->सुसवी
सुशिख->सुशीक
सुशीत->सुसित
सुशीम->सुसीम
सूकर->सूकार
सूकर->सूखर
सूचि->सूची
सूचिक->सूचीक
सूचिपत्त्रक->सूचीपत्त्रक
सूचिपुष्प->सूचीपुष्प
सूचिरोमन्->सूचीरोमन्
सूति->सूती
सूनु->सूनू
सूरत->सूरथ
सूरि->सूरी
सूर्म्मि->सूर्म्मी
सृणि->सृणी
सृणिका->सृणीका
सृप->सृफ
सेक->सैक
सेर->सैर
सोदय->सौधाय
सोदर->सौधार
सोभाञ्जन->सौभाञ्जन
सोम->सौम
सोमप->सोमाप
सोमप->सौमाप
सोमपत्र->सोमपात्र
सोमपीतिन्->सोमपीथिन्
सौचिक->सौचीक
सौभरि->सौभरी
सौरि->सौरी
स्कन्द->स्कान्द
स्कन्ध->स्कान्द
स्कन्धिन्->स्कान्धिन्
स्तन->स्थन
स्तनान्तर->स्थानान्तर
स्तम्बेरम->स्ताम्बेरम
स्तरिमन्->स्तरीमन्
स्तव->स्ताव
स्तव->स्थव
स्तिमित->स्तीमित
स्तुति->स्तुती
स्तृ->स्थृ
स्तॄ->स्थृ
स्तेम->स्थेम
स्तेय->स्थैय
स्तोत्रिय->स्तोत्रीय
स्तोभ->स्तौभ
स्त्येन->स्त्यैन
स्त्रीवश->स्त्रीवास
स्थग->स्थाग
स्थग->स्थाघ
स्थापत्य->स्थापथ्य
स्थिति->स्थिती
स्थूणा->स्थूरा
स्थेय->स्थैय
स्नपन->स्नापन
स्नव->स्नाव
स्नुहि->स्नुही
स्पर्शन->स्पर्शान
स्पर्शन->स्पार्शन
स्पश->स्पाश
स्पृ->स्पॄ
स्फटि->स्फटी
स्फटि->स्फाटि
स्फटिक->स्फाटिक
स्फटिक->स्फाटीक
स्फटिकारि->स्फटिकारी
स्फुटि->स्फुटी
स्फुत्कर->स्फुत्कार
स्फुर्ज->स्फूर्ज
स्फोटायन->स्फौटायन
स्मय->स्माय
स्मर->स्मार
स्मरण->स्मारण
स्यन्दनि->स्यन्दनी
स्रव->स्राव
स्रवण->स्रावण
स्रुत->स्रूत
स्रोत->स्रौत
स्वतन्त्र->स्वातन्त्र
स्वदन->स्वदान
स्वदन->स्वधन
स्वदन->स्वादन
स्वदन->स्वादान
स्वधिति->स्वधिती
स्वधिति->स्वधीति
स्वन->स्वान
स्वनि->स्वानि
स्वपन->स्वापन
स्वप्न->स्वाप्न
स्वभाव->स्वाभाव
स्वभू->स्वाभू
स्वयम्भु->स्वयंभू
स्वयम्भु->स्वायम्भू
स्वयम्भू->स्वायम्भू
स्वर->स्वार
स्वर्णकण->स्वर्णाकर
स्वर्णकार->स्वर्णाकर
स्वर्णशेफालिका->स्वर्णसेफालिका
स्वल्प->स्वाल्प
स्ववासिनी->स्वावासिनी
स्वस्ति->स्वस्ती
स्वस्ति->स्वस्थी
स्वस्रीय->स्वास्रीय
स्वाति->स्वाती
हंसवती->हंसावती
हंसाङ्घ्रि->हंसाङ्घ्री
हटपर्णि->हटपर्णी
हनु->हनू
हनुमत्->हनूमत्
हन्तकार->हन्ताकार
हरि->हरी
हरि->हारी
हरिक->हारिक
हरिण->हारिण
हरितक->हरीतक
हरितक->हारीतक
हरिदश्व->हारिदश्व
हरिद्रव->हारिद्रव
हर्म्य->हार्म्य
हलभृत्->हालभृत्
हलाह->हालाह
हलाहल->हालहाल
हवनी->हावनी
हवनीय->हावनीय
हसन->हासन
हस्त->हास्त
हस्तिदन्त->हास्तिदन्त
हस्तिनापुर->हास्तिनपुर
हस्तिनापुर->हास्तिनापुर
हस्तिशुण्डा->हस्तिसुण्डा
हहल->हहाल
हहल->हाहल
हहल->हाहाल
हारि->हारी
हारितक->हारीतक
हालहल->हालहाल
हिड->हीड
हिण्डिर->हिण्डीर
हित->हीत
हिरण्यय->हिरण्याय
हिल->हीLअ
हिलमोचि->हिलमोची
हु->हू
हुतवह->हुतवाह
हुहु->हुहू
हुहु->हूहू
हूहु->हूहू
हृ->हॄ
हृदिक->हृदीक
हेड->हेढ
हेतु->हेतू
हेमकूट->हैमकूट
हेमन्त->हैमन्त
हेरम्ब->हेरम्भ
हेरम्ब->हेराम्ब
हेरम्ब->हैरम्ब
होड->होढ
होमि->होमी
होम्य->हौम्य
ह्मल->ह्माल
ह्रस्व->ह्रास्व
ह्वल->ह्वाल
ह्वृ->ह्वॄ
अग्रसन्धानी->अग्रसन्धनी
अपची->अपचि
अपत्यसाच्->अपत्यसच्
अपाप->अपप
अपराङ्मुख->अपरङ्मुख
अपराह्ण->अपराःण
अपरूप->अपरुप
अपार्ण->अपर्ण
अपालम्ब->अपलम्ब
अपवाद->अपवद
अपावृत->अपवृत
अपावृति->अपवृति
अपावृत्ति->अपवृत्ति
अपश्री->अपश्रि
अपष्ठ->अपष्ट
अपाष्ठ->अपष्ट
अपासृत->अपसृत
अपीच्य->अपिच्य
अपेक्षाबुद्धि->अपेक्षबुद्धि
अप्रखर->अप्रकर
अप्रखर->अप्रकार
अप्राण->अप्रण
अप्रतिष्ठ->अप्रतिष्ट
अप्रधान->अप्रदान
अप्रभाव->अप्रभव
अप्रमाद->अप्रमद
अप्रामाणिक->अप्रमाणिक
अप्रसक्त->अप्रशक्त
अप्रसक्ति->अप्रशक्ति
अफलाकाङ्क्षिन्->अफलकाङ्क्षिन्
अभद्र->अबध्र
अभि->अबि
अभी->अबि
अभिध्या->अबिद्या
अभीत->अबीत
अभीर->अबीर
अब्धि->अब्दि
अब्राह्मण->अब्रह्मण
अभाग->अभग
अभावनीय->अभवनीय
अभितराम्->अभितरम्
अभिधा->अभिदा
अभीपत्->अभिपत्
अभीप्सित->अभिप्सित
अभिभू->अभिभु
अभिमातिषाह्->अभिमातिषह्
अभीरु->अभिरु
अभीवर्ग->अभिवर्ग
अभिषाच्->अभिषच्
अभिषाह्->अभिषह्
अभीषु->अभिषु
अभीषु->अभिषू
अभिसम्पात->अभिसंपत
अभीशु->अभिसू
अभिहार->अभिहर
अभ्यसन->अभ्यशन
अभ्याचार->अभ्याचर
अभ्युपेत्याशुश्रूषा->अभ्युपेत्यशुश्रूषा
अभ्यूह->अभ्युह
अभ्यूह्य->अभ्युह्य
अमांस->अमंस
अमरावती->अमरावति
अमामासी->अमामसी
अमृतासु->अमृताशु
अम्बरीष->अम्बरिष
अम्बुकण्ठक->अम्बुकण्टक
अम्बूकृत->अम्बुकृत
अम्लसार->अम्लशार
अम्ली->अम्लि
अयाचित->अयचित
अयाथातथ्य->अयथातथ्य
अयस्->अयश्
अयास्य->अयस्य
अयाथातथ्य->अयाथतथ्य
अयुताजित्->अयुतजित्
अररि->अरणी
अरण्यकार्पासी->अरण्यकर्पासी
अरण्याध्यक्ष->अरण्यध्याक्ष
अरण्यवास्तूक->अरण्यवास्तुक
अरण्यानी->अरण्यानि
अरण्यौकस्->अरण्योकस्
अराति->अरथी
अराय->अरय
अरीढ->अरिढ
अर्घ->अर्ग
अर्घ्य->अर्ग्य
अर्द्धासन->अर्द्धाशन
अर्पिस->अर्पिश
अलजी->अलजि
अलाबू->अलाबु
अवकाश->अवकश
अवखाद->अवकाद
अवाकिन्->अवकिन्
अवगुण्ठन->अवगुण्टन
अवाग्र->अवघ्र
अवाञ्चित->अवञ्चित
अवर->अवण
अवार->अवण
अवतार->अवतर
अवधातव्य->अवदातव्य
अवधार->अवदार
अवधेय->अवदेय
अवनीपाल->अवनिपाल
अवबाधा->अवबधा
अवभृथ->अवभृत
अवमान्य->अवमन्य
अवाय->अवय
अवयाज्->अवयज्
अवारण->अवरण
अवारपार->अवरपर
अवारिका->अवरिका
अववाद->अववद
अवसक्थिका->अवशक्थिका
अवासिन्->अवशिन्
अवसित->अवशीत
अवसक्थिका->अवसक्तिका
अवसान->अवसन
अवान्तराम्->अवान्तरम्
अविष्ठ->अविष्ट
अवैध->अवेद
अव्यथि->अव्यति
अव्यथि->अव्यती
अशनाया->अशनया
अशास्त्र->अशस्त्र
अशील->अशिल
अशून्य->अशुन्य
अशौच->अशोच
अश्लीक->अश्लिक
अश्वपाद->अश्वपद
अश्वीय->अश्विय
अष्टाकपाल->अष्टकपाल
अष्टपाद्->अष्टपद्
अष्टापद->अष्टपद
अष्टापद->अष्टपाद
असंस्थित->असंस्तीत
असाधन->असादन
असामान्य->असामन्य
असिक्नी->असिक्नि
असुख->असुक
असूक्षण->असुक्षण
असूत->असुत
असृग्धरा->असृग्दरा
असौष्ठव->असौष्टव
अस्ताघ->अस्ताग
अस्थाग->अस्ताग
अस्थिति->अस्तिति
अस्थि->अस्ती
अस्वाध्याय->अस्वध्याय
अस्वास्थ्य->अस्वस्थ्य
अहीन->अहिन
अहैतुक->अहेतुक
अह्नाय->अह्नय
आख->आक
आकारण->आकरण
आखु->आकु
आकूत->आकुत
आखु->आकू
आक्षार->आक्षाण
आखर->आखण
आघात->आगथ
आगू->आगु
आग्नीध्र->आग्निध्र
आग्रहायण->आग्रहयण
आघ्रेय->आग्रेय
आघातन->आघतन
आछ->आच
आचार->आचर
आजान->आजन
आजानि->आजनि
आटरूष->आटरुष
आढक->आडक
आडारक->आडाणक
आडू->आडु
आर->आण
आतान->आतन
आदान->आदन
आधान->आदन
आदिताल->आदितल
आदीनव->आदिनव
आदिपूरुष->आदिपुरुष
आधि->आदी
आधान->आधन
आधार->आधर
आनाथ्य->आनत्य
आनस->आनश
आन्वीक्षिकी->आन्वीक्षिकि
आपातलिका->आपतालिका
आपालि->आपलि
आपस्->आपश्
आपीत->आपित
आप्री->आप्रि
आबाध->आबध
आभील->आभिल
आभ्यासिक->आभ्याशिक
आमात्य->आमत्य
आमात्य->आमथ्य
आयःशूलिक->आयःशुलिक
आयाति->आयती
आरातीय->आरतीय
आर्जीक->आर्जिक
आर्थ->आर्त
आलान->आलन
आलापन->आलपन
आलाप्य->आलप्य
आलम्भ->आलंब
आलम्भ्य->आलम्ब्य
आवारि->आवरि
आवली->आवलि
आवाहन->आवहन
आवी->आवि
आविस्->आविश्
आस्->आश्
आसक्ति->आशक्ति
आशास्य->आशस्य
आसार->आशार
आशी->आशि
आसिका->आशिका
आशीर्वाद->आशिर्वाद
आसीन->आशीन
आसुति->आशुति
आसुर->आशूर
आस्य->आश्य
आस्या->आश्या
आश्वबाल->आश्वबल
आश्वास्य->आश्वस्य
आषाढि->आषाडी
आषाढी->आषाडी
आहू->आहु
आहूति->आहुती
आह्वारक->आह्वरक
इला->इLआ
इज्याशील->इज्यशील
ईड->इड
इन्दीवार->इन्दीवर
इन्दूर->इन्दुर
ईम्->इम्
ईरामा->इरामा
ईलित->ईLइत
उख->उक
उकार->उकण
उखा->उका
उक्थाशस्त्र->उक्थशास्त्र
उग्रादेव->उग्रदेव
उच्चारण->उच्चरण
उच्चारित->उच्चरित
उच्छासन->उच्चासन
उच्छिलीन्ध्र->उच्छिलीन्द्र
उच्छून->उच्छुन
उड्डामर->उड्डमर
उड्डीयन->उड्डियान
उत्कारिका->उत्कणिका
उत्खाय->उत्कय
उत्कारिका->उत्करिका
उत्खला->उत्कला
उत्खाय->उत्काय
उत्कास->उत्काश
उत्कासन->उत्काशन
उत्कूल->उत्कुल
उत्थापन->उत्तपन
उत्तारक->उत्तरक
उत्तारण->उत्तरण
उत्तरात्->उत्तरत्
उत्तराम्->उत्तरम्
उत्तराहि->उत्तरहि
उत्तरौष्ठ->उत्तरोष्ठ
उत्थापन->उत्तापन
उत्तिष्ठमान->उत्तिष्टमान
उत्पलावती->उत्पलवती
उत्पाली->उत्पली
उत्फाल->उत्फल
उत्सक्थ->उत्सक्त
उत्सादन->उत्सदन
उत्सारण->उत्सरण
उत्साह->उत्सह
उत्सेध->उत्सेद
उदापु->उदपू
उदाहार->उदाहर
उदीक्षण->उदिक्षण
उद्घ->उद्ग
उद्घन->उद्गान
उद्गीथ->उद्गीत
उद्घाटक->उद्घटक
उद्घाटित->उद्घटित
उद्दाम->उद्दम
उद्धम->उद्दम
उद्दाल->उद्दल
उद्धय->उद्दाय
उद्ध्य->उद्द्य
उद्धान->उद्धन
उद्धार->उद्धर
उद्धूत->उद्धुत
उद्धूषण->उद्धुषण
उद्भास->उद्भस
उद्भूति->उद्भुति
उद्वान->उद्वन
उद्वास->उद्वस
उन्मान->उन्मन
उपकार->उपकर
उपकूल->उपकुल
उपाक्ष->उपक्ष
उपाख्या->उपख्या
उपगूढ->उपगुड
उपचार->उपचर
उपढौकन->उपढोकन
उपतापन->उपतपन
उपधान->उपदान
उपादान->उपदान
उपादिक->उपदीक
उपदेशसाहस्री->उपदेशसहस्री
उपधान->उपधन
उपादान->उपधन
उपादिक->उपधिक
उपाधि->उपधी
उपाध्याय->उपध्याय
उपानह्->उपनह्
उपपात->उपपथ
उपमात्->उपमथ्
उपयान->उपयन
उपायन->उपयन
उपलम्भ->उपलम्ब
उपालम्भ->उपलम्ब
उपवासन->उपवसन
उपावृत्->उपवृत्
उपावृत्त->उपवृत्त
उपसद->उपशद
उपशान्ति->उपशन्ति
उपासक->उपशाक
उपसि->उपशी
उपाश्रय->उपश्रय
उपाश्रित->उपश्रित
उपासङ्ग->उपसङ्ग
उपासङ्ग->उपसङ्घ
उपासादित->उपसादित
उपासन->उपसान
उपासित->उपसित
उपास्ति->उपस्थि
उपासित->उपाशित
ऊम->उम
उम्भि->उंबी
ऊररी->उररी
उरस्->उरश्
ऊररी->उरारि
ऊरुग्राह->उरुग्राह
उरुवूक->उरुवुक
ऊर्ज्जित->उर्ज्जित
ऊर्वङ्ग->उर्वङ्ग
उलूक->उलुक
ऊलूक->उलुक
ऊलुपिन्->उलुपिन्
उलूपी->उलुपी
ऊलुपिन्->उलूपिन्
उल्लास->उल्लस
उल्लू->उल्लु
उशाना->उशना
ऊषण->उषर
ऊषर->उषर
उष्णांशु->उष्णंशु
उष्णासह->उष्णसह
उष्णीगङ्ग->उष्णिगङ्ग
उष्णीष->उष्णिष
ऊह्य->उह्य
ऊह्यगान->उह्यगान
ऊरी->ऊणि
ऊरुग्राह->ऊरुग्रह
ऊर्वष्ठीव->ऊर्वष्टीव
ऋणादान->ऋणदान
ऋणावन्->ऋणवन्
ऋतसाप्->ऋतसप्
ऋत्वियावत्->ऋत्वियवत्
ऋषीवत्->ऋषिवत्
ऐकध्यम्->एकध्यम्
एकपत्नी->एकपत्नि
एकपाद्->एकपद्
ऐकपदिक->एकपदिक
एकवीराकल्प->एकवीरकल्प
ऐकात्म्य->एकात्म्य
ऐकादशिन->एकादशिन
ऐकान्तिक->एकान्तिक
एकावली->एकावलि
एकाष्ठील->एकाष्टील
ऐण->एर
ऐर->एर
ऐल->एल
एलापत्र->एलपत्र
एलापुर->एलपुर
ऐलवालुक->एलवालुक
ऐलविल->एलविल
ऐलवालुक->एलावालुक
ऐषीक->एषिक
ऐकध्यम्->ऐकद्यम्
ऐभी->ऐभि
ऐलाक->ऐलक
ऐषीक->ऐषिक
औक्थ->ओक्त
औख्य->ओक्य
औजस्य->ओजस्य
औड्र->ओड्र
औड->ओढ
औड्र->ओढ्र
औत्स->ओत्स
औदक->ओदक
औदनिक->ओदनिक
औदन्य->ओदन्य
औदरिक->ओदरिक
औषधि->ओषधी
औष्ट्र->ओष्ट्र
औष्ठ्य->ओष्ठ्य
औपाधिक->औपधिक
औपसद->औपशद
औरस->औरश
औषर->औषण
कंस->कंश
ककुभ्->ककुब्
काक्षी->कक्षी
कङ्कुष्ठ->कङ्कुष्ट
काञ्चनप्रभ->कञ्चनप्रभ
काञ्चि->कञ्ची
कञ्चूल->कञ्चुल
कञ्जार->कञ्जाण
कटाक्ष->कटक्ष
कटप्रू->कटप्रु
कटार->कटर
कठर->कटर
कठाहक->कटाहक
कठिका->कटिका
कठिनी->कटिनी
कटिशृङ्खला->कटिशृङ्कला
काट्य->कट्य
काठक->कठक
कडार->कडर
करक->कणक
कारक->कणक
करज->कणज
कारज->कणज
कारव->कणव
करशीकर->कणशीकर
कारा->कणा
करिका->कणिका
कारिका->कणिका
करिन्->कणिन्
करिष्ठ->कणिष्ठ
कारि->कणी
कारी->कणी
करिका->कणीका
कारिका->कणीका
कर्करी->कण्काणि
कण्टकाढ्य->कण्टकाड्य
कण्टकी->कण्टकि
कण्टकीद्रुम->कण्टकिद्रुम
कण्ठी->कण्टी
काण्ड->कण्ड
काण्डीर->कण्डीर
कण्डूरा->कण्डुरा
कण्डूल->कण्डुल
कात्->कत्
कातर->कतर
काथिक->कतिक
कथित->कतिथ
कात्->कथ्
काथिक->कथिक
काति->कथी
कात्य->कथ्य
कादम्बा->कदम्बा
कादाचित्क->कदाचित्क
कनिष्ठ->कनिष्ट
कनिष्ठक->कनिष्टक
कानिष्ठिनेय->कनिष्ठिनेय
कान्ति->कन्ति
कान्तारी->कन्थारी
कन्दालु->कन्दलु
कन्याकुब्ज->कन्यकुब्ज
कान्यकुब्ज->कन्यकुब्ज
कन्याधन->कन्यादान
कापटिक->कपटिक
कापाटिक->कपटिक
कपाल->कपल
कफल->कपल
कापाल->कपल
काफल->कपल
कापालिक->कपालिक
कपिकच्छू->कपिकच्छु
कपीत->कपित
कपिलावट->कपिलवट
कपिलाह्रद->कपिलह्रद
कापिवन->कपिवन
कापिशायन->कपिशायन
कापिष्ठल->कपिष्ठाल
कपोतपाली->कपोतपालि
कापा->कफा
कापिल->कफिल
कमठ->कमट
कामलिन्->कमलिन्
कामलिका->कमलीका
कामालिका->कमलीका
कामि->कमि
काम्पिल्य->कम्पिल्य
काम्पील->कम्पील
कम्बू->कंबु
कम्भु->कंबु
कम्भु->कंबू
कम्भारी->कम्भारि
कयाधू->कयाधु
कराङ्गण->करङ्गण
कारणिक->करणिक
कारण्डव्यूह->करण्डव्यूह
करताली->करतली
करन्धम->करन्दम
कारन्धम->करन्दम
करपात्र->करपत्र
कारापथ->करपात
कारभू->करभू
करम्भ->करंब
कराल->करल
कारव->करव
कारवल्ली->करवल्ली
करशाखा->करशाका
करशूक->करशुक
कारापथ->करापात
कारि->करि
कारी->करि
करिणी->करिणि
करीरी->करिणि
कारीरी->करिणि
कारि->करी
कारी->करी
कर्करी->कर्करि
कर्कारु->कर्करु
कर्त्तरी->कर्त्तरि
कार्दम->कर्दम
कार्म्म->कर्म्म
कलाद->कलद
कलधूत->कलधुत
कलन्धु->कलन्दु
कलाय->कलय
कलाविकल->कलविकल
कलसि->कलशी
कलाची->कलाचि
कवाट->कवट
कवारि->कवरी
कव्यवाह्->कव्यवह्
कशीका->कशिका
कसेरुका->कशेरुका
कसेरु->कशेरू
कषीका->कषिका
कस्तूरी->कस्तूरि
कह्लार->कह्लण
कांस्यनील->कांश्यनील
काकारि->काकणि
काकारि->काकणी
काकनासा->काकनाशा
काकार->काकर
काकरूक->काकरुक
काकिणी->काकिणि
काकिनी->काकिनि
काकोली->काकोलि
काक्षी->काक्षि
कारि->काणि
कारी->काणि
काण्व->काण्Vअ
काण्डपृष्ठ->काण्डपृष्ट
कात्यायनी->कात्यायनि
कादम्बरी->कादम्बरि
कान्थक->कान्तक
कान्थिक->कान्तिक
कान्थिक->कान्तीक
कामान्ध->कामन्द
कामरूपिन्->कामरुपिन्
कामशास्त्र->कामशस्त्र
काम्पील->काम्पिल
कारणकारण->कारणकरण
कारणशरीर->कारणशरिर
कारापथ->कारपथ
काराधुनी->काराधुनि
कार्षापण->कार्षपण
कालखञ्ज->कालकाञ्ज
कालपृष्ठ->कालपृष्ट
काली->कालि
कालीयक->कालियक
काशीखण्ड->काशिखण्ड
काशीनाथ->काशिनाथ
काशू->काशु
काष्ठकुद्दाल->काष्टकुद्दाल
काष्ठधात्रीफल->काष्ठधत्रीफल
काष्ठलौहिन्->काष्ठलोहिन्
कीकट->किकट
किकीदिवि->किकिदिवि
किकीदिवि->किकिदीवि
किखि->किकी
कीकि->किकी
किङ्कर->किङ्कण
किङ्किर->किङ्किण
किङ्किणी->किङ्किणि
किङ्किणीकाश्रम->किङ्किणिकाश्रम
कीचक->किचक
किरि->किणी
कीरि->किणी
किरीट->किरिट
कीश->किस
कुकुर->कुकुण
कुकूल->कुकुल
कुठर->कुटार
कुठार->कुटार
कुठिक->कुटिक
कुठिक->कुटीक
कुठेर->कुटेर
कुट्टापरान्त->कुट्टपरान्त
कुट्टापरान्त->कुट्टापरन्त
कुण्ठ->कुण्ट
कूदर->कुदार
कुद्दाल->कुद्दल
कूद्दाल->कुद्दल
कूदर->कुधर
कूपाङ्क->कुपङ्क
कुपथ->कुपत
कूपक->कुपाक
कूमनस्->कुमनस्
कुमारी->कुमारि
कुम्भीक->कुम्बिक
कुम्भकारी->कुम्भकारि
कुम्भी->कुम्भि
कुम्भीनस->कुम्भिनस
कुलघ्न->कुलग्न
कुलाट->कुलट
कूलास->कुलस
कुलाह->कुलह
कुवाद->कुवद
कुशावती->कुशवति
कुशावती->कुशवती
कुसल->कुशाल
कुशी->कुशि
कुसिम्बी->कुशिम्बी
कुष्ठ->कुष्ट
कूष्माण्डी->कुष्माण्डी
कुसू->कुसु
कुसुमायुध->कुसुमयुध
कुसुम्भ->कुसुम्ब
कुहूरव->कुहुरव
कूटशाल्मलि->कूटशल्मलि
कूर्पास->कूर्पस
कूलवती->कूलवति
कूष्माण्डी->कूष्माण्डि
कृकलास->कृकलाश
कृताग्नि->कृतघ्नी
कृताय->कृतय
कृतसापत्निका->कृतसपत्निका
कृतावसक्थिक->कृतावशक्थिक
कृतिरात->कृतिरथ
कॄत->कृथ
कृष्णागुरु->कृष्णगुरु
कृष्णरूप्य->कृष्णरुप्य
कृष्णावास->कृष्णवास
कृष्णाष्टमी->कृष्णाष्टमि
कै->के
कैकय->केकाय
कैतव->केतव
केयूर->केयुर
कैवल->केवाल
केसराचल->केशराचल
केसराम्ल->केशराम्ल
केसरिका->केशरिका
कैलास->कैलाश
कोकामुख->कोकमुख
कोटिकास्य->कोटिकाश्य
कोटिफल->कोटिपाल
कौणप->कोणप
कौर्प्य->कोर्प्य
कोलनासिका->कोलनाशिका
कौलिक->कोलिक
खोलि->कोली
कौवेर->कोवेर
कोसल->कोशल
कौशल->कोशल
कौशलिका->कोशलिका
कोशी->कोशि
कौशिक->कोशिक
कौशिका->कोशिका
कौशीधान्य->कोशीधान्य
कौश->कोस
कौदालीक->कौदालिक
कौमोदकी->कौमोदकि
खोर->कौर
कौरुपाञ्चाल->कौरुपञ्चाल
खोलि->कौलि
खोलि->कौली
कौषीतक->कौषितक
क्रमागत->क्रमगत
क्रायक->क्रयक
क्रियाकार->क्रियाकर
क्रियापाद->क्रियापद
क्रुध्->क्रुद्
क्रौञ्चदारण->क्रोञ्चदारण
क्रौञ्चपदा->क्रोञ्चपदा
क्रौञ्चपदी->क्रोञ्चपदी
क्रौष्टुकि->क्रोष्टुकी
क्षारिका->क्षणिका
क्षपणी->क्षपणि
क्षमावत्->क्षमवत्
क्षामवत्->क्षमवत्
क्षामास्य->क्षमस्य
क्षारक->क्षरक
क्षारित->क्षरित
क्षिपणी->क्षिपणि
क्षीण->क्षिर
क्षीर->क्षिर
क्षीरपाण->क्षीणपण
क्षीरवत्->क्षीणवत्
क्षीरशर->क्षीणसार
क्षीरसार->क्षीणसार
क्षीरधि->क्षीणाधि
क्षुरक->क्षुणक
क्षुध्->क्षुद्
क्षौणी->क्षोणी
क्षौणीभुज्->क्षोणीभुज्
क्षौर->क्षोर
क्षौणी->क्षौणि
खङ्गीक->खङ्गिक
खजाक->खजक
खञ्जार->खञ्जर
खट्वाका->खट्वका
खडी->खडि
खड्गारीट->खड्गारिट
खर->खण
खार->खण
खरकर->खणखण
खाण्डव->खण्डव
खण्डी->खण्डि
खाण्डिक->खण्डीक
खादन->खदन
खाद्य->खद्य
खनी->खनि
खानि->खनि
खानिक->खनिक
खमूली->खमूलि
खरकुटी->खरकुटि
खरमञ्जरी->खरमञ्जरि
खारि->खरी
खलीकार->खलिकार
खल्ली->खल्लि
खल्लीट->खल्लिट
खल्वाट->खल्वट
खस->खश
खशीर->खशिर
खारीक->खारिक
खुरासान->खुराशान
खै->खे
गाङ्ग->गङ्ग
गङ्गादत्त->गङ्गदत्त
गाङ्गेष्ठी->गङ्गेष्टि
गजपिप्पली->गजपिप्पलि
गाजर->गजर
गजवीथी->गजवीथि
गरागरी->गणगारि
गणपाठ->गणपाट
गरा->गणा
गण्डीर->गण्डिर
गर्व->गण्व
गन्धनाकुली->गन्धनाकुलि
गन्धमादन->गन्धमदन
गन्धमांसी->गन्धमांसि
गरिष्ठ->गरिष्ट
गर्भाधान->गर्भधान
गविष्ठ->गविष्ट
घाति->गाथि
घाति->गाथी
गायत्री->गायत्रि
घण->गार
घर->गार
घार->गार
गार्गी->गार्गि
गार्हस्थ्य->गार्हस्त्य
घल->गाल
घिण->गिर
गुङ्गू->गुङ्गु
गुच्छाल->गुच्छल
घुटि->गुटी
घुटि->गुठि
गुणग्राहिन्->गुणग्रहिन्
गुणान्वित->गुणन्वित
घुणाक्षर->गुणाक्षर
घुणि->गुणि
घुरी->गुणि
घुणि->गुणी
घुरी->गुणी
घुण्ट->गुण्ठ
गुण्डारोचनिका->गुण्डरोचनिका
गुण्डासिनी->गुण्डाशिनी
गुफित->गुपित
घुम्->गुम्
घुणि->गुरी
घुरी->गुरी
गुरुदैवत->गुरुदेवत
घुलञ्च->गुलञ्च
गुलुञ्छ->गुलुञ्च
घूक->गूक
गूढपाद्->गूढपद्
गूढपाद->गूढपद
घुणि->गूरी
घुरी->गूरी
गृण्डीव->गृण्डिव
गृध->गृद
गृध्रकूट->गृध्रकुट
गृध्री->गृध्रि
गृभीत->गृभित
गोकर्णी->गोकर्णि
गोचारक->गोचरक
गौण->गोण
गौर->गोण
घोर->गोण
घौर->गोण
गौरा->गोणा
घोणा->गोणा
घोरा->गोणा
गोणी->गोणि
गौरि->गोणि
गौरी->गोणि
गौणिक->गोणिक
गौरिक->गोणिक
गोरिका->गोणिका
गौरीपुत्र->गोणीपुत्र
गौदानिक->गोदानिक
गोदावरी->गोदावरि
गौधार->गोधार
गोनस->गोनश
गोपी->गोपि
गौपिक->गोपिक
गोपीत->गोपित
गोपीथ->गोपित
गौपिक->गोपीक
गोबाल->गोबल
गौरक्ष्य->गोरक्ष्य
गौरव->गोरव
गौराश्व->गोराश्व
गौरास्य->गोरास्य
गोलाङ्गूल->गोलाङ्गुल
घोष->गोष
घोषक->गोषक
गौष्ठीन->गोष्ठीन
गौरि->गौणी
गौरी->गौणी
घोरक->गौरक
घोरवाशन->गौरवासन
घ्राति->ग्रथि
ग्राभ->ग्रभ
ग्रामकुक्कुट->ग्रमकुक्कुट
ग्रामघात->ग्रमघात
ग्रामयाजिन्->ग्रमयाजिन्
ग्राम्य->ग्रम्य
ग्राहक->ग्रहक
ग्रहणी->ग्रहणि
ग्रहाधार->ग्रहधार
ग्रहामय->ग्रहमय
ग्रामघात->ग्रामगत
ग्रामणी->ग्रामणि
घटी->घटि
घटीयन्त्र->घटियन्त्र
घटीकार->घटीकर
घाटिका->घटीका
घण्टाली->घण्टालि
घाण्टिक->घण्टिक
घनाघन->घनघन
घाटाल->घाटल
घूक->घुक
घुष्टान्न->घुष्टन्न
घृताची->घृताचि
घोर->घोण
घौर->घोण
घोरक->घोणक
घ्राति->घ्रति
चक्रीवत्->चक्रिवत्
चक्रेश्वरी->चक्रेश्वरि
चक्षुस्->चक्षुश्
चङ्कुर->चङ्कुण
चञ्चरीक->चञ्चरिक
चतुःफला->चतुःपला
चतुरूषण->चतुरुषण
चतुर्थकाल->चतुर्थकल
चतुष्पाद्->चतुष्पद्
चन्द्रालोक->चन्द्रलोक
चन्द्री->चन्द्रि
चमू->चमु
चम्पकावती->चम्पकवती
चारी->चरी
चारित्र->चरीत्र
चारुक->चरुक
छवि->चवी
छा->चा
चाण्डाली->चाण्डालि
छत्त्र->चात्त्र
छात्त्र->चात्त्र
छदि->चादि
चान्द्री->चान्द्रि
छालिक्य->चालिक्य
चीक->चिक
चिक्किर->चिक्किण
चिरि->चिणी
चीरि->चिणी
छित्ति->चित्ती
चित्रवाण->चित्रवर
चित्रौदन->चित्रोदन
छिदि->चिदि
छिन्न->चिन्न
चीरपर्ण->चिरपर्ण
चिराय->चिरय
चीरिका->चिरिका
चीलिका->चिलिका
चीर->चीण
चीरक->चीणक
चीनाक->चीनक
चीरिणी->चीरिणि
चुचू->चुचु
छुच्छु->चुच्चु
छुच्छु->चुच्चू
चूडामणि->चुडामणि
छुरी->चुरी
छूरी->चुरी
चूरु->चुरु
चुल्ली->चुल्लि
छुड->चूड
छुरी->चूरि
छूरी->चूरि
छुरिका->चूरिका
छूरिका->चूरिका
छुरी->चूरी
छूरी->चूरी
छृप->चृप
छेक->चेक
चैदिक->चेदिक
छैदिक->चेदिक
छेदि->चेदी
छेलक->चेलक
चैत्री->चैत्रि
छेलक->चैलक
छो->चो
छोटिका->चोटिका
चौलुक्य->चोलुक्य
चौर->चौण
च्यौत्न->च्योत्न
छत्त्राधान्य->छत्त्रधान्य
छात्त्रि->छत्त्री
छन्दस्->छन्दश्
छल्ली->छल्लि
छिक्कर->छिक्कण
छिक्कार->छिक्कण
छैदिक->छेदिक
जगती->जगति
जागर->जगार
जङ्घारि->जङ्गारि
जङ्घाल->जङ्घल
जाङ्गल->जङ्घल
जाटालिका->जटालिका
जतूका->जतुका
जातूकर्ण->जतूकर्ण
जानायन->जनायन
जानु->जनु
जानु->जनू
जनौ->जनो
जापन->जपन
जाबाल->जबाल
जम्पती->जम्पति
जम्भ->जम्ब
जम्बीर->जम्बिर
जम्भीर->जम्बिर
जाम्बीर->जम्बिर
जम्बूल->जम्बुल
जम्भारि->जम्भरि
जायक->जयक
जयन्ती->जयन्ति
जयरात->जयरथ
जयावती->जयवती
जरायु->जरयु
जारण->जरर
जारी->जरी
जरूथ->जरुथ
जालक->जलक
जलजम्बूका->जलजम्बुका
जलाञ्जलि->जलञ्जलि
जलद्वीप->जलद्विप
जालपाद->जलपाद
जलरूप->जलरुप
जलसूचि->जलशुचि
जल्पाक->जल्पक
जाहक->जहाक
जहिस्तम्भ->जहिस्तम्ब
जाह्नवी->जह्नावी
जागरूक->जागरुक
जाघनी->जाघनि
जाटालिका->जाटलिका
जातूकर्ण->जातुकर्ण
जाम्बवौष्ठ->जाम्बवोष्ठ
जाम्बूनद->जाम्बुनद
जारूथी->जारुथी
जालपाद->जालपद
जाली->जालि
जाह्नवी->जाह्नवि
जिघत्नु->जिगत्नु
जिङ्गी->जिङ्गि
जीति->जिति
जीरण->जिरण
जीर्वि->जिर्वि
जीवनी->जिवनी
जीवजीव->जिवाजीव
जीवधन->जीवदान
जीवनी->जीवनि
जीवन्ती->जीवन्ति
जूषण->जुषाण
जुहू->जुहु
जुहुराण->जुहुरण
जुहूराण->जुहुरण
जुहूवत्->जुहुवत्
जुह्वास्य->जुह्वस्य
जैत्र->जेत्र
जैन->जेन
ज्ञात->ज्ञत
ज्यानि->ज्ञानी
ज्ञीप्स्यमान->ज्ञिप्स्यमान
ज्यु->ज्ञु
झ्यु->ज्ञु
ज्यैष्ठी->ज्येष्ठी
ज्यैष्ठ्य->ज्येष्ठ्य
ज्योतिस्->ज्योतिश्
ज्यौतिषिक->ज्योतिषीक
ज्योत्स्नी->ज्योत्स्नि
ज्वालामुखी->ज्वलमुखी
ज्वालिन्->ज्वलिन्
ज्वालाजिह्व->ज्वालजिह्व
झाङ्कृत->झङ्कृत
झर->झण
झर्च्छ->झर्च्च
झर्झ->झर्ज
झर्झर->झर्जर
झालि->झलि
झिरिका->झिणिका
झिण्टी->झिण्टि
झीरुका->झिरुका
टीका->टिका
डकार->डकर
ढकार->डकर
ढक्कारी->डक्कारी
डाङ्गरी->डङ्गारी
डाकिनी->डाकिनि
ढाल->डाल
ढुण्ढि->डुण्ढि
ढाल->ढल
ढुण्ढि->ढुण्डि
णी->णि
तलित्->तLइत्
तकरी->तकरि
तक्रकूर्चिका->तक्रकुर्चिका
तटाक->तटक
तडाग->तडग
ताडघ->तडग
ताडाग->तडग
ताडका->तडाका
ताण्डिन्->तण्डिन्
तण्डुलीक->तण्डुलिक
तथात्व->ततत्व
तथ्य->तत्य
तादृश->तदृश
तद्भाव->तद्भव
तन्थी->तन्ती
तान्व->तन्व
तन्वी->तन्वि
तपस्->तपश्
तपस->तपश
तापस->तपश
तामर->तमर
तामसी->तमसी
तामलकी->तमालकी
तामु->तमु
ताराक्ष->तरक्ष
तारिका->तरिका
तारिन्->तरिन्
तरूट->तरुट
तरुणाय->तरुणय
तरुणी->तरुणि
तर्कारी->तर्कारि
तार्णक->तर्णक
तर्दू->तर्दु
तालवन->तलवन
तालक->तलाक
तालिन्->तलिन्
तावक->तवक
ताविष->तवीष
ताम्बूलिक->ताम्बुलिक
ताम्रकूट->ताम्रकुट
ताम्रपर्णी->ताम्रपर्णि
ताम्रावती->ताम्रवती
तालूर->तालुर
तिथि->तिति
तित्तिरीक->तित्तिरिक
तीर->तिर
तिरश्ची->तिरश्चि
तिरस्कारिन्->तिरस्करिन्
तिलौदन->तिलोदन
तूणव->तुणव
तूणीर->तुणीर
तूबर->तुबर
तूणक->तुरक
तूणी->तुरी
तूरी->तुरी
तुर्फरी->तुर्फरि
तूर्वि->तुर्वी
तूलक->तुलक
तुलसी->तुलसि
तूलि->तुली
तुषारकर->तुषारकण
तुहिनकर->तुहिनकण
तूणी->तूणि
तूरी->तूणि
तूणीक->तूणिक
तूष्णीकाम्->तूष्णीकम्
तॄ->तृ
तृणकुटी->तृणकुटि
तृफला->तृपला
तृफू->तृपु
तेजःफल->तेजःपाल
तैजस->तेजस
तेदनी->तेदनि
तोयडिम्भ->तोयडिम्ब
तोयाधिवासिनी->तोयादिवासिनी
त्रायोदश->त्रयोदश
त्रायन्ती->त्रायन्ति
त्रिपाद्->त्रिपद्
त्रिपाद->त्रिपद
त्रिपादिका->त्रिपदिका
त्रिपुटीफल->त्रिपुटिफल
त्रिपृष्ठ->त्रिपृष्ट
त्रिभङ्गी->त्रिभङ्गि
त्रिभण्डी->त्रिभण्डि
त्रिभाव->त्रिभव
त्रिवेणी->त्रिवेणि
त्रिशाण->त्रिशर
त्रिसर->त्रिशर
त्रिसाहस्र->त्रिसहस्र
त्र्याक्षायण->त्र्यक्षायण
त्र्यस्र->त्र्यश्र
त्र्यहीन->त्र्यहिन
त्वाष्ट्र->त्वष्ट्र
त्वै->त्वे
त्सारुक->त्सरुक
दंसि->दंशी
दाक्षक->दक्षक
दाक्षि->दक्षि
दाक्षी->दक्षि
दक्षिणापथ->दक्षिणपथ
दक्षिणाबन्ध->दक्षिणबन्ध
दाक्षि->दक्षी
दाक्षी->दक्षी
दाक्ष्य->दक्ष्य
दाडी->दडी
दाण्डपाता->दण्डपाता
दत्तामित्र->दत्तमित्र
दधित्थ->ददित्थ
दाधित्थ->ददित्थ
दाधिक->दधिक
दधिसार->दधिशर
दधिसार->दधिसर
दाधृषि->दधृषि
दन्ताघात->दन्तघात
दन्तपाली->दन्तपालि
दन्तशठ->दन्तशट
दन्ती->दन्ति
दान्ति->दन्ति
दन्दशूक->दन्दशुक
दारण->दरण
दारि->दरी
दारी->दरी
दर्भ->दर्ब
दार्भ->दर्ब
दर्भट->दर्बट
दर्भि->दर्बि
दार्भि->दर्बि
दर्भर->दर्भण
दार्भ्य->दर्भ्य
दर्वीकर->दर्विकर
दार्वी->दर्वी
दार्शपौर्णमासिक->दर्शपौर्णमासिक
दालि->दली
दाल्भ्य->दल्भ्य
दावाग्नि->दवाग्नि
दाशतयी->दशतयी
दशान्त->दशन्त
दशामय->दशमाय
दाशरात्रिक->दशरात्रिक
दशसाहस्र->दशसहस्र
दासी->दशि
दसेरक->दशैरक
दाशेरक->दशैरक
दस्र->दश्र
दास्र->दश्र
दासी->दसि
दाशु->दसु
दाक्षायण->दाक्षयाण
दाक्षायणी->दाक्षायणि
दाडी->दाडि
दार->दाण
दारि->दाणि
दारी->दाणि
दासी->दाशी
दासी->दासि
दी->दि
दीक्षणीय->दिक्षणीय
दीक्षा->दिक्षा
दीक्षापति->दिक्षापति
दीर्ण->दिण्ण
दीदिवि->दिदिवि
दीदि->दिदी
दीधी->दिदी
दीदिवि->दिदीवि
दीदि->दिधि
दीधी->दिधि
दिधिषूपति->दिधिषुपति
दिधीषू->दिधीषु
दीननाथ->दिननाथ
दीनार->दिनार
दिव्यौघ->दिव्योघ
दीधिति->दीदिति
दीधी->दीदी
दीधी->दीधि
दीर्घकण्ठ->दीर्घकण्ट
दीर्घपाद्->दीर्घपद्
दीर्घायुस्->दीर्घयुस्
दुःख->दुःक
दुःसक्थ->दुःशक्त
दुःशास->दुःशस
दुःशासन->दुःशसन
दुराप->दुरफ
दुराधन->दुरादान
दुरूह->दुरुह
दुर्दुरूट->दुर्दुरुट
दूर्य->दुर्य
दुर्विध->दुर्विद
धूर्वी->दुर्वी
दूली->दुली
धूलि->दुली
दुष्टरीतु->दुष्टरितु
दुष्ठु->दुष्टु
धूः->दुह्
दूणाश->दूणश
धूति->दूती
धुर्->दूर्
दूरापात->दूरपथ
दूरापात->दूरपात
धुर्य्य->दूर्य्य
धुर्व->दूर्व
धूलिका->दूलिका
धूश->दूस
दृशद्वती->दृशद्वति
धृष्टकेतु->दृष्टकेतु
धृष्टरथ->दृष्टरथ
देवकीनन्दन->देवकिनन्दन
दैवकीनन्दन->देवकिनन्दन
दैवत्य->देवत्य
दैवदर्शनिन्->देवदर्शनिन्
देवदूती->देवदूति
देवनदी->देवनदि
दैवन्त्यायन->देवन्त्यायन
दैवमति->देवमति
देवरथ->देवरत
देवरात->देवरत
दैवराति->देवरति
दैवराति->देवराति
दैवलक->देवलक
दैववाणी->देववाणी
दैवासुर->देवशूर
दैवस्थानि->देवस्थानि
दैवारिप->देवारिप
देवावास->देवावस
दैवासुर->देवासुर
देवी->देवि
दैवी->देवि
दैविक->देवीक
दैवादिक->दैवदिक
दौःसाधिक->दोःसाधिक
दोघ->दोग
दोध->दोद
दौर्गन्ध्य->दोर्गन्ध्य
दोषाकर->दोषकर
द्यविद्यवी->द्यविद्यवि
द्रावण->द्रवण
द्रावण->द्रवर
द्राविडी->द्रविडी
द्रविणोदस्->द्रविणोदश्
द्रेष्काण->द्रेष्कण
द्रौणायनि->द्रोणायनि
द्वार्->द्वर्
द्वारिन्->द्वरिन्
द्वादशवार्षिक->द्वादशवर्षिक
द्वीन्द्रियग्राह्य->द्विन्द्रियग्राह्य
द्विपृष्ठ->द्विपृष्ट
द्विरदान्तक->द्विरदन्तक
द्विरूढा->द्विरुढा
द्वैतवन->द्वेतवन
द्वैध->द्वेद
द्वैधीभाव->द्वैधिभाव
धनच्छू->धनच्छु
धनाश्री->धनश्री
धनाशा->धनसा
धानक->धनाक
धनी->धनि
धानी->धनि
धानुष्क->धनुष्क
धानेय->धनेय
धन्ध->धन्द
धन्याक->धन्यक
धान्याक->धन्यक
धान्या->धन्या
धामनिका->धमनिका
धाणक->धरक
धारक->धरक
धाराट->धरट
धरणीभृत्->धरणिभृत्
धरणीसुत->धरणिसुत
धारणी->धरणी
धारणीय->धरणीय
धाराङ्कुर->धराङ्कुर
धाराफल->धरापाल
धावन->धवन
धावनि->धवनी
धातुकासीस->धातुकाशीश
धात्री->धात्रि
धान्याक->धान्यक
धान्यकोष्ठक->धान्यकोष्टक
धान्यमाय->धान्यमय
धारणी->धारणि
धारापात->धारापथ
धीरस्कन्ध->धीरस्कन्द
धूः->धुः
धूक->धुक
धूतपाप->धुतपाप
धूति->धुति
धूनन->धुनन
धूनन->धुनान
धूनि->धुनी
धूर->धुर
धूर्वह->धुर्वह
धूर्वी->धुर्वी
धूस्तूर->धुस्तूर
धूर->धूण
धूमाय->धूमय
धूमावती->धूमवती
धूलीकदम्ब->धूलिकदम्ब
धौती->धौति
ध्वजाहृत->ध्वजहृत
नल->नLअ
नाल->नLअ
नख->नक
नाक->नक
नखर->नकर
नखर->नकार
नाकुलक->नकुलक
नाकुलि->नकुली
नखालु->नखलु
नागरखण्ड->नगरखण्ड
नागरमुस्ता->नगरमुस्ता
नागराज->नगराज
नगारि->नगरी
नागरी->नगरी
नागरोत्था->नगरोत्था
नागेश->नगेश
नाचिकेत->नचिकेत
नाचीन->नचीन
नाटक->नटक
नाटित->नटित
नदी->नदि
नदीज->नदिज
नाद्य->नद्य
नान्दिकर->नन्दिकर
नान्दीकर->नन्दिकर
नान्दीपुर->नन्दिपुर
नान्दी->नन्दी
नान्दीक->नन्दीक
नान्दीपुर->नन्दीपुर
नान्दीमुख->नन्दीमुख
नाभ्->नभ्
नभस्->नभश्
नाभाग->नभाग
नाभि->नभि
नाम->नम
नमी->नमि
नायक->नयक
नरायण->नरयाण
नारायण->नरयाण
नरव्याघ्र->नरव्याग्र
नारसिंह->नरसिम्ह
नारा->नरा
नाराच->नराच
नारीष्ठ->नरिष्ट
नरिष्ठा->नरिष्टा
नर्मरा->नर्मणा
नलिनी->नलिनि
नलोपाख्यान->नलोपख्यान
नवरात्र->नवरत्र
नवसार->नवसर
नाविन्->नविन्
नस->नश
नाश->नश
नाशन->नशन
नागकेसर->नागकेशर
नागफल->नागपाल
नागवल्ली->नागवल्लि
नागवीथी->नागवीथि
नारा->नाणा
नारी->नाणी
नान्दी->नान्दि
नान्दीक->नान्दिक
नामग्राह->नामग्रह
नामधेय->नामदेय
नारायणी->नारायणि
नारी->नारि
नारीष्ठ->नारिष्ट
नारीष्ठ->नारिष्ठ
नासिका->नाशिका
नासीर->नाशिर
नास्य->नाश्य
नासीर->नासिर
निःसंशय->निःशंसय
निःसरण->निःशरण
निःसारण->निःशरण
निःसार->निःशाण
निःशूक->निःशुक
निःसार->निःसर
निःसार->निःसाण
निकारण->निकरण
निकाष->निकष
निकाश->निकस
निकास->निकस
निघ->निग
निगाल->निगल
नितत्नी->नितत्नि
निधा->निदा
निधनवत्->निदानवत्
निधि->निदी
निपाक->निपक
निपातन->निपतन
निभ->निब
निरञ्छन->निरञ्चन
निरस्थि->निरस्ति
निराकाङ्क्ष->निराकङ्क्ष
निरृथ->निरृत
निर्गुण्ठी->निर्गुण्टी
निर्गुण्डी->निर्गुण्डि
निर्झर->निर्जर
निर्भर->निर्बाण
निर्वाञ्च्->निर्वञ्च्
निर्वाह->निर्वह
निर्वीर->निर्विण
नील->निल
नीलङ्गु->निलङ्गु
निवारण->निवरण
निवास->निवाश
नीवि->निवि
नीवि->निवी
निशठ->निशट
निशाट->निशट
निशादि->निशदि
निशादि->निशधि
निशारण->निशरण
निसर->निशाण
निसार->निशाण
नीशार->निशाण
निशीथ->निशिथ
निस्रव->निश्रव
निषध->निषद
निषाद->निषद
निषादकर्षू->निषादकर्षु
निष्कास->निष्काश
निष्ठान->निष्टन
निष्ठीव->निष्टीव
निष्ठान->निष्ठन
निष्ठीव->निष्ठिव
निष्ठीवन->निष्ठिवन
निष्पाद्->निष्पद्
निष्प्रवाणि->निष्प्रवणि
निस्वान->निस्वन
नील->नीLअ
नीराजन->नीरजन
नीरूप->नीरुप
नीलपृष्ठ->नीलपृष्ट
नीलस्कन्धा->नीलस्कन्दा
नूद->नुद
नैश->नेश
नैशिक->नेशिक
नैपात्य->नैपथ्य
नैरूहिक->नैरुहिक
नैषादक->नैषधक
नैष्ठिक->नैष्टिक
न्यासिन्->न्यसिन्
पञ्चाक्षर->पञ्चक्षार
पञ्चाज->पञ्चज
पञ्चप्रासाद->पञ्चप्रसाद
पञ्चशैरीषक->पञ्चशैरिषक
पटकुटी->पटकुटि
पठि->पटी
पट्टीश->पट्टिस
परत्व->पणत्व
परम्->पणम्
परस्त्री->पणस्त्री
परायति->पणायति
पण्याजीव->पण्यजीव
पथक->पतक
पथक->पताक
पथिक->पतिक
पथिन्->पतिन्
पत्त्रसिरा->पत्त्रशिरा
पत्त्री->पत्त्रि
पत्नी->पत्नि
पथ्य->पत्य
पदष्ठीव->पदष्टीव
पद्मावती->पद्मवती
पयस्->पयश्
पराक->परक
पराक्रम->परक्रम
परादन->परधन
परादान->परधन
पराभव->परभाव
परमानन्द->परमनन्द
परमार्थ->परमार्त
परस्->परश्
परारि->पराणी
पारस->परास
पाराशर->परासर
परिक्षाण->परिक्षण
परीक्षण->परिक्षण
परीक्षा->परिक्षा
पाणिक->परिख
पारिख->परिख
परिघ->परिग
पाणिघ->परिग
पाणिग्रहण->परिग्रहण
पाणिग्रहीतृ->परिग्रहीतृ
पारिजात->परिजात
परीणस्->परिणश्
परीणह्->परिणह्
पारिपन्थिक->परिपन्थिक
पाणिपीडन->परिपीडन
पारिभाव्य->परिभाव्य
पाणिभुज्->परिभुज्
पारिमाण्डल्य->परिमाण्डल्य
पाणिमुक्त->परिमुक्त
पारियानिक->परियानिक
पारिरक्षक->परिरक्षक
परिवार->परिवाण
परिवी->परिवि
परिव्राज्->परिव्रज्
परिस्रव->परिश्रव
परिस्रुत्->परिश्रुत्
परिस्रुत->परिश्रुत
परिषूति->परिषुति
परिष्कर->परिष्कण
परिष्कार->परिष्कण
परीसार->परिसार
परिहार->परिहर
परिहार->परिहाण
पाणि->परी
पारी->परी
पाणिवाद->परीवाद
परीसार->परीसर
पारुष्य->परुष्य
पारु->परू
पर्णवी->पर्णवि
पर्णास->पर्णाश
पर्पटी->पर्पटि
पर्याय->पर्यय
पार्वतायन->पर्वतायन
पलाश->पलस
पालाश->पलस
पालक->पलाक
पलाली->पलालि
पालाशि->पलाशी
पालिका->पलिका
पाल्लक->पल्लक
पाल्वलतीर->पल्वलतीर
पवीतृ->पवितृ
पाशुक->पशुक
पाशुपाल्य->पशुपाल्य
पाशुबन्धक->पशुबन्धक
पश्चिमानूपक->पश्चिमानुपाक
पष्ठवाह्->पष्टवह्
पष्ठवाह्->पष्ठवह्
पांसुकुली->पांशुकुली
पाची->पाचि
पाञ्चालिका->पाञ्चलिका
पाठ->पाट
पाठिन्->पाटिन्
पारक->पाणक
पाणिघात->पाणिगत
पारिपात्र->पाणिपात्र
पारी->पाणी
पाणौकरण->पाणोकरण
पाथोधर->पाथोदर
पादपीठ->पादपीट
पादशस्->पादशश्
पानीयवर्णिका->पानियवर्णिका
पानीयफल->पानीयपल
पान्थ->पान्त
पान्नागारि->पान्नगारि
पारापार->पारपार
पारमार्थिक->पारमर्थिक
पारम्परीण->पारंपरिण
पारलौकिक->पारलोकिक
पारस->पारश
पारी->पारि
पारीण->पारिण
पारिभाव्य->पारिभव्य
पारिमाण्डल्य->पारिमण्डल्य
पार्ष्ठिक->पार्ष्टिक
पार्ष्णिग्राह->पार्ष्णिग्रह
पाशुपाल्य->पाशुपल्य
पिञ्जूल->पिञ्जुल
पीडा->पिडा
पीड->पिढ
पिण्डस->पिण्डश
पितृरूप->पितृरुप
पिपीलिकामध्य->पिपीलिकमध्य
पिलुपर्णी->पिलुपर्णि
पिसङ्ग->पिशन्ग
पिशाची->पिशाचि
पिष्टपूर->पिष्टपुर
पीतसालक->पीतशालक
पीथि->पीती
पू->पु
पुञ्जिकास्थला->पुञ्जिकस्थला
पुटी->पुटि
पूरक->पुणक
पूरिका->पुणिका
पुथ->पुत
पूत->पुत
पुत्रपौत्र->पुत्रपोत्र
पूति->पुथि
पून->पुन
पूरक->पुरक
पुरवासिन्->पुरवसिन्
पुरस्->पुरश्
पुरार्द्धविस्तार->पुरार्द्धविस्तर
पूरिका->पुरिका
पुरीषाधान->पुरीषधान
पुरूरवस्->पुरुरवस्
पुरूवसु->पुरुवसु
पुरुहूत->पुरुहुत
पूरु->पुरू
पुरोधस्->पुरोदास्
पूलास->पुलस
पूलिका->पुलिका
पूलिका->पुलीका
पूतीकरञ्ज->पूतिकरञ्ज
पूतीका->पूतिका
पूथिका->पूतिका
पूपाली->पूपली
पूर्वातिथि->पूर्वतिथि
पूर्वभाव->पूर्वभव
पूषासुहृत्->पूषसुहृत्
पृथूदर->पृथुधार
पृष्ठज->पृष्टज
पृष्ठवाह्->पृष्ठवह्
पैञ्जूष->पेञ्जूष
पैठिक->पेटिक
पेस्वर->पेश्वर
पेषाक->पेषक
पोथकी->पोतकी
पोथकी->पोथकि
पौतिक->पोथिक
पौर->पोर
पौरक->पोरक
पौलि->पोली
पौष->पोष
पौञ्जिष्ठ->पौञ्जिष्ट
पौण्ड्रमात्स्यक->पौण्ड्रमत्स्यक
पौष्टी->पौष्टि
प्रकाश->प्रकश
प्रगाथ->प्रगत
प्रघात->प्रगत
प्रघण->प्रगाण
प्रचलाकिन्->प्रचलकिन्
प्रच्छान->प्रच्छन
प्रजनू->प्रजनु
प्रणाली->प्रणालि
प्रणी->प्रणि
प्रताप->प्रतप
प्रतापन->प्रतपन
प्रतमाम्->प्रतमम्
प्रतारण->प्रतरण
प्रतिताली->प्रतितालि
प्रतिधा->प्रतिदा
प्रतिफलन->प्रतिपालन
प्रतिरथ->प्रतिरत
प्रतिस्रोतस्->प्रतिश्रोतस्
प्रतिष्कस->प्रतिष्कश
प्रतिष्ठान->प्रतिष्ठन
प्रतिसारण->प्रतिसरण
प्राति->प्रती
प्रतीची->प्रतीचि
प्रथिवी->प्रतीवी
प्रथिष्ठ->प्रतीष्ट
प्रतोली->प्रतोलि
प्रत्यक्स्रोतस्->प्रत्यक्श्रोतस्
प्रत्याधान->प्रत्यदन
प्रत्यायन->प्रत्ययन
प्रात्ययिक->प्रत्ययिक
प्रत्याश्राव->प्रत्यश्रव
प्रत्याधान->प्रत्यादान
प्राथमकल्पिक->प्रथमकल्पिक
प्रथिवी->प्रथिवि
प्रथिष्ठ->प्रथिष्ट
प्राधनिक->प्रदानिक
प्राधानिक->प्रदानिक
प्रधि->प्रदी
प्रधी->प्रदी
प्राधान्य->प्रधन्य
प्राधान्य->प्रधान्य
प्रापणिक->प्रपाणिक
प्रपुन्नाड->प्रपुन्नड
प्रभु->प्रबू
प्रभावत्->प्रभवत्
प्रभृथ->प्रभृत
प्राभृत->प्रभृत
प्रमाण->प्रमण
प्रमथ->प्रमत
प्रमाथ->प्रमत
प्रमाथिन्->प्रमथिन्
प्रमाण->प्रमर
प्रामाद्य->प्रमाद्य
प्रमीढ->प्रमीड
प्रायणीय->प्रयाणीय
प्ररूढ->प्ररुढ
प्रलम्भ->प्रलंब
प्रालम्ब->प्रलंब
प्रवाच्->प्रवच्
प्रवाणी->प्रवणि
प्रावणि->प्रवणि
प्रवाणी->प्रवणी
प्रावणि->प्रवणी
प्रवाद->प्रवद
प्रवारण->प्रवरण
प्रावरण->प्रवरण
प्रवासन->प्रवसन
प्रवार->प्रवाण
प्रावण->प्रवाण
प्रावर->प्रवाण
प्रावार->प्रवाण
प्रवाणी->प्रवाणि
प्रावणि->प्रवाणि
प्रवीण->प्रविर
प्रवीर->प्रविर
प्रावृत->प्रवृत
प्रावृष्->प्रवृष्
प्रशंसन->प्रशंशन
प्रशंसा->प्रशंशा
प्रासक->प्रशक
प्रसक्ति->प्रशक्ति
प्रसल->प्रशल
प्रशासन->प्रशसन
प्रासक->प्रशाख
प्रसातिका->प्रशातिका
प्रसित->प्रशित
प्राशित->प्रशित
प्रसित->प्रशीत
प्राशित->प्रशीत
प्रसून->प्रशून
प्रस्रवण->प्रश्रवण
प्रष्ठवाह्->प्रष्ठवह्
प्रासङ्ग->प्रसङ्घ
प्रसाधक->प्रसादक
प्रसाधन->प्रसादन
प्रसाधित->प्रसादित
प्राशु->प्रसु
प्रसूत->प्रसुत
प्रसूति->प्रसुति
प्राशु->प्रसू
प्रस्ताव->प्रस्तव
प्रास्थानिक->प्रस्थानिक
प्रास्थिक->प्रस्थिक
प्रस्राव->प्रस्रव
प्रहर->प्रहण
प्रहार->प्रहण
प्रहाणि->प्रहणि
प्रहाणि->प्रहरी
प्रहार->प्रहाण
प्रह्वलीका->प्रह्वलिका
प्राक्स्रोतस्->प्राक्श्रोतस्
प्राघात->प्रागाथ
प्राघार->प्रागार
प्राणनाथ->प्राणनथ
प्राधा->प्रादा
प्राधनिक->प्रादानिक
प्राधानिक->प्रादानिक
प्रायस्->प्रायश्
प्रास->प्राश
प्रासक->प्राशक
प्रेतीषणि->प्रेतिषणि
प्रेष्ठ->प्रेष्ट
प्रौष्ठिक->प्रोष्ठिक
प्लक्षप्रस्रवण->प्लक्षप्रश्रवण
प्लावित->प्लवित
प्लीहा->प्लिहा
फाणि->फणि
फणिकेसर->फणिकेशर
फाणित->फणित
फाणि->फणी
फल्गुनी->फल्गुनि
बला->बLआ
बाला->बLआ
भकार->बकार
भङ्ग->बङ्ग
भज->बज
भट्ट->बट्ट
भण्ड->बण्ड
बदरी->बदरि
बाधा->बधा
भम्भराली->बम्भरालि
भम्भराली->बम्भराली
भम्भराली->बंभराली
भरट->बरट
भरु->बरु
बालक->बलक
बलाकाश्व->बलकाश्व
बलाकिन्->बलखिन्
बालधि->बलदी
बलाय->बलय
बलास->बलस
बालक->बलाक
बालाकि->बलाकि
बालधि->बलाधि
बलास->बलाश
बलीक->बलिक
बालिश->बलिश
बालीश->बलिश
बालि->बली
बालुक->बलूक
बालूक->बलूक
भल्ल->बल्ल
भल्लवि->बल्लवी
भल्लुक->बल्लुक
बाल्हिक->बल्हिक
बाल्हिक->बल्हीक
बाहुदन्तक->बहुदन्तक
बहुधार->बहुधर
बहुपाद->बहुपद
बाहुलक->बहुलक
बहुसू->बहुसु
भा->बा
भड->बाढ
भरस्->बाणस्
भदन्त->बाधान्त
भण->बार
भर->बार
भलता->बालता
भलन्दन->बालन्दन
भव->बाव
भस->बास
बिस->बिश
बुस->बुश
बृहद्भानु->बृहद्बानु
बृहन्नारायणोपनिषद्->बृहन्नारयणोपनिषद्
बौधायन->बोधायन
बौध्य->बोध्य
ब्राह्म->ब्रह्म
ब्राह्मक->ब्रह्मक
ब्राह्मगुप्त->ब्रह्मगुप्त
ब्राह्मण->ब्रह्मण
ब्रह्मरात->ब्रह्मरथ
ब्रह्मवाद->ब्रह्मवद
ब्रह्मवाद->ब्रह्मवध
ब्राह्मणी->ब्राह्मणि
भाक्तिक->भक्तिक
भगदैवत->भगदेवत
भागधेय->भगधेय
भगिनी->भगिनि
भङ्गकार->भङ्गकर
भरित->भणित
भण्डीरी->भण्डिरी
भद्रकार->भद्रकर
भद्रपीठ->भद्रपिठ
भद्रपीठ->भद्रपीट
भद्रशाख->भद्रशाक
भद्रसालवन->भद्रशालवन
भम्भासार->भम्भसार
भरद्वाज->भरद्वज
भल्लाट->भल्लट
भल्ली->भल्लि
भस्त्राफला->भस्त्रफला
भस्मसात्->भस्मसत्
भागहार->भागहर
भागीरथी->भागिरथी
भारती->भारति
भारवाह->भारवह
भारहार->भारहर
भारूप->भारुप
भार्गी->भार्गि
भाल्लूक->भाल्लुक
भाष्यकार->भाष्यकर
भीरु->भिरु
भीरू->भिरु
भीरुकच्छ->भिरुकच्छ
भू->भु
भुजङ्गविजृम्भित->भुजङ्गविजृम्बित
भुजादल->भुजदल
भूर्->भुर्
भूरि->भुरि
भूर्ज->भुर्ज
भुशुण्डी->भुशुण्डि
भूजम्बू->भूजम्बु
भूतार्थ->भूतार्त
भूपाल->भूपल
भूयस्->भूयश्
भृकुंस->भृकुंश
भृङ्गार->भृङ्गाण
भैषज्य->भेषज्य
भोगावली->भोगावलि
भोगीन्द्र->भोगिन्द्र
भौत->भोत
भ्राज->भ्रज
भ्रमत्कुटी->भ्रमत्कुटि
भ्राष्ट्र->भ्रष्ट्र
भ्रामर->भ्रामण
भ्रास->भ्राश
भ्रू->भ्रु
भ्रूभङ्ग->भ्रुभङ्ग
मकारः->मकरः
मकुष्ठ->मकुष्ट
मक्कूल->मक्कुल
मघी->मगि
मघी->मघि
मज्जारस->मज्जरस
मञ्जरीनम्र->मञ्जरिनम्र
मञ्जुभाषिन्->मञ्जुभषिन्
मञ्जूषा->मञ्जुषा
मणीचक->मणिचक
मणिमन्थ->मणिमन्त
मणीवक->मणिवक
मणिसर->मणिशर
मण्डूक->मण्डुक
मधुर->मदुर
मधूक->मधुक
मधुपर्णी->मधुपर्णि
मधुफल->मधुपाल
मधुपुरी->मधुपुरि
मधूल->मधुल
मधुस्रव->मधुश्रव
मधुश्रेणी->मधुश्रेणि
मनस्->मनश्
मनोरथ->मनोरत
मयूख->मयूक
मारण->मरार
मारि->मरि
मारि->मरी
मारीच->मरीच
मार्ग->मर्ग
मर्माविध्->मर्मविद्
मार्ष->मर्ष
मार्ष्टि->मर्ष्टि
मालक->मलक
मलपू->मलपु
मालव->मलव
माला->मला
मालाकार->मलाकार
मालिक->मलिक
मास्->मश्
मसन->मशन
मासन->मशन
मास्->मस्
मासर->मसार
मासिक->मसिक
मसूरी->मसूरि
महावराह->महवराह
महासेन->महसेन
माहाकुल->महाकूल
महाजम्बू->महाजम्बु
माहात्म्य->महात्म्य
महानाद->महानद
महानदी->महानदि
महानील->महानिल
महाफल->महापाल
महामाया->महामया
महासार->महाशर
महासान्तपन->महासन्तापन
महैला->महेला
माहेश्वर->महेश्वर
महोत्साह->महोत्सह
मांसी->मांसि
माञ्जिष्ठ->माञ्जिष्ट
मार->माण
मारि->माणि
माथ->मात
माथुर->मातुर
माद्री->माद्रि
माधुरी->माधुरि
माध्वीक->माध्विक
मायूरी->मायूरि
मारीच->मारिच
मालती->मालति
मालाकार->मालाकर
मीलन->मिलन
मीलित->मिलित
मुख->मुक
मूक->मुक
मुक्तापुष्प->मुक्तपुष्प
मुक्ताप्रालम्ब->मुक्ताप्रलम्ब
मुक्तावली->मुक्तावलि
मूत->मुथ
मुधा->मुदा
मुस->मुश
मुसल्य->मुशल्य
मुसल्लह->मुशल्लह
मुहुस्->मुहुश्
मूत्राघात->मूत्रघात
मृगजीवन->मृगजिवन
मृगलाञ्छन->मृगलाञ्चन
मेखला->मेकला
मेढ्र->मेड्र
मैत्रावरुण->मेत्रावरुण
मेदस्->मेदश्
मेधस्->मेदश्
मेदिनी->मेदिनि
मेध्य->मेद्य
मोघ->मोग
मौञ्जी->मौञ्जि
म्रदिष्ठ->म्रदिष्ट
याजक->यजाक
यज्ञवल्ली->यज्ञवल्लि
याज्ञसेनी->यज्ञसेनि
याज्य->यज्य
यातव्य->यतव्य
यातु->यतु
यात्रा->यत्रा
यादृच्छिक->यदृच्छिक
याप्य->यप्य
यामिनी->यमिनी
यामि->यमी
यामी->यमी
याम्य->यम्य
ययाति->ययति
यायावर->ययावर
यवफल->यवपाल
यावन->यवान
यविष्ठ->यविष्ट
यस->यश
यास->यश
यशस्->यशश्
यष्टीक->यष्टिक
याष्टीक->यष्टिक
याज्य->याज्ञ
याज्ञसेनी->याज्ञसेनि
यायावर->यायवर
याष्टीक->याष्टिक
यूति->युति
यूथी->युति
युध्->युद्
युद्ध->युद्द
युवती->युवति
योगाचार->योगचर
यौगिक->योगिक
यौधेय->योधेय
यौन->योन
रक्तकेसर->रक्तकेशर
रजनीकर->रजनिकर
रजनीचर->रजनिचर
रजनीजल->रजनिजल
रजनीमुख->रजनिमुख
रत्नाकर->रत्नकर
रत्नावली->रत्नावलि
राद्ध->रद्द
राद्ध->रद्ध
रमठ->रमट
रामठ->रमट
रामणीयक->रमणीयक
रामण->रमाण
रावण->रवाण
रसन->रशन
रस्य->रश्य
रासक->रसक
रास्ना->रस्ना
राख->राक
राजादन->राजदन
राजादन->राजधन
राजादन->राजधान
राजफल->राजपाल
राढ->राड
रासभ->राशभ
रिख->रिक
रिक्तभाण्ड->रिक्तभण्ड
रुचिराञ्जन->रुचिरञ्जन
रूपक->रुपक
रेखा->रेका
रेणुरूषित->रेणुरुषित
रैत्य->रेत्य
रेफस्->रेपस्
रैवतक->रेवतक
रेवती->रेवति
रोची->रोचि
रौच्य->रोच्य
रौट->रोट
रोध->रोद
रौप्य->रोप्य
रौम->रोम
रोमकेसर->रोमकेशर
रोहिणी->रोहिणि
रौहिणेय->रोहिणेय
रोहिताश्व->रोहितश्व
लाक्षण्य->लक्षण्य
लाक्षा->लक्षा
लक्ष्मी->लक्ष्मि
लक्ष्मीनृसिंह->लक्ष्मिनृसिंह
लक्ष्मीफल->लक्ष्मीपल
लघिष्ठ->लघिष्ट
लङ्घन->लङ्गन
लाङ्गल->लङ्गल
लाङ्गली->लङ्गली
लाङ्गूल->लङ्गूल
लाञ्छन->लञ्छन
लालाटिक->ललाटिक
लवली->लवलि
लासिका->लसीका
लाघ->लाग
लाङ्गली->लाङ्गलि
लाङ्गूल->लाङ्गुल
लाङ्गूलिका->लाङ्गुलिका
लाटानुप्रास->लाटानुप्राश
लाभ->लाब
लालास्राव->लालास्रव
ली->लि
लिम्पाक->लिम्पक
लीला->लिला
लू->लु
लूता->लुता
लेख->लेक
लौड->लोड
लौहमल->लोहमल
लौहज->लोहाज
लौहित्य->लोहित्य
वांशी->वंशी
वक्षस्->वक्षश्
वाच्->वच्
वाचक->वचक
वटी->वटि
वाटिका->वटिका
वार्->वण्
वारिज->वणिज
वातायन->वतायन
वाति->वति
वात्स्य->वत्स्य
वदान्य->वदन्य
वादर->वदर
वादि->वदि
वाद्य->वद्य
वाद->वध
वाध->वध
वादरत->वधरत
वादित्र->वधित्र
वादिन्->वधिन्
वादिर->वधिर
वादि->वधी
वधू->वधु
वधूटी->वधुटी
वाद्य->वध्य
वनकार्पासी->वनकार्पसि
वनकार्पासी->वनकार्पसी
वनकार्पासी->वनकार्पासि
वनामल->वनमाल
वानर->वनर
वन्दाका->वन्दका
वापीह->वपीह
वामी->वमी
वायस->वयस
वार्->वर्
वाराणसी->वरणसी
वाराणसी->वरणाशी
वरदाचतुर्थी->वरदचतुर्थी
वरादन->वरदान
वरादन->वरधान
वरमुखी->वरमुकी
वारयितृ->वरयितृ
वराण->वरर
वारण->वरर
वरासन->वरसान
वाराणसी->वराणसी
वरी->वरि
वाणि->वरि
वारि->वरि
वारु->वरु
वार्णिक->वर्णिक
वार्त्त->वर्त्त
वर्त्तनी->वर्त्तनि
वार्मण->वर्मण
वार्षक->वर्षक
वार्षिक->वर्षिक
वलाक->वलक
वलीक->वलिक
वल्मीक->वल्मिक
वाल्मीक->वल्मिक
वाल्मिकि->वल्मीकि
वल्लकी->वल्लकि
वल्लीज->वल्लिज
वसन->वशन
वसति->वशाति
वसि->वशि
वसि->वशी
वसुधा->वसुदा
वसुधारा->वसुधरा
वसुमती->वसुमति
वस्वौकसारा->वस्वोकसारा
वागुजी->वागुजि
वाराणसी->वाणरसी
वारवाण->वाणवार
वाराणसी->वाणारसी
वारिज->वाणिज
वारि->वाणी
वाताण्ड->वातण्ड
वातायन->वातयान
वाद्यभाण्ड->वाद्यभण्ड
वानरी->वानरि
वामोरू->वामोरु
वाराणसी->वारणसी
वाराणसी->वारणासी
वाराही->वाराहि
वारिवाह->वारिवह
वार्त्तायन->वार्त्तयन
वार्भट->वार्बट
वासक->वाशक
वासन->वाशन
वासव->वाशव
वासि->वाशि
वासित->वाशित
वासि->वाशी
वासुरा->वाशुरा
वास्तूक->वास्तुक
विकाश->विकस
विकुर्वाण->विकुर्वण
विक्षीर->विक्षीण
विघ्न->विग्न
विचार->विचर
विचारण->विचरण
विचारित->विचरित
विचाल->विचल
विडौजस्->विडोजस्
वितथ->वितत
वितान->वितन
विदारण->विदरण
विधान->विदान
विदारी->विदारि
विदारीगन्धा->विदारिगन्धा
विधि->विदि
विधेय->विदेय
विधान->विधन
विनाश->विनस
विन्ध्यावली->विन्ध्यावलि
विपाश्->विपश्
विपाश्->विपस्
विफल->विपाल
विभाज्य->विभज्य
विभाण्डक->विभण्डक
विमान->विमन
वियात->वियत
विराग->विरग
विराट->विरट
विराध->विरद
विराम->विरम
विराव->विरव
विरूढ->विरुढ
विरूप->विरुप
विरूपाक्ष->विरुपाक्ष
विवाद->विवध
विवाह->विवह
विविध->विविद
विशाखल->विशकल
विशारण->विशरण
विशारद->विशरद
विशाल->विशल
विशल्यकरणी->विशल्यकरणि
विशृङ्खल->विशृङ्कल
विश्वानर->विश्वनर
विश्वामित्र->विश्वमित्र
विश्वाराज्->विश्वराज्
विश्वावसु->विश्ववसु
विश्वस्था->विश्वस्ता
विश्वाची->विश्वाचि
विषाण->विषण
विषार->विषण
विषारि->विषणि
विषयाज्ञान->विषयज्ञान
विषारि->विषाणी
विष्ठल->विष्टल
विष्ठा->विष्टा
विष्वाण->विष्वण
विहार->विहाण
वीहार->विहाण
वीरवत्->वीणावत्
वृथा->वृता
वृन्ताक->वृन्तक
वृन्दार->वृन्दर
वृषाकपायी->वृषकपायी
वृहतीपति->वृहतिपति
वैणिक->वेणिक
वैरिन्->वेणिन्
वेथ->वेत
वैतालीय->वेतालीय
वेधक->वेदक
वेदाधिप->वेददीप
वेधनी->वेदनी
वेधमुख्य->वेदमुख्य
वैदिक->वेदिक
वेधित->वेदित
वेधिनी->वेदिनी
वैदिक->वेदीक
वैद्य->वेद्य
वैद्या->वेद्या
वैद्य->वेध्य
वैद्या->वेध्या
वैराट->वेरट
वेलाकूल->वेलाकुल
वैशाख->वेशक
वेसन->वेशन
वेसवार->वेशवार
वैशस->वेशस
वैशिक->वेशिक
वैर->वैण
वैध->वैद
वैदेही->वैदेहि
वैयाघ्र->वैयग्र
वैराट->वैरट
वोल्लाह->वोल्लह
व्याज->व्यज
व्याड->व्यड
व्यतीपात->व्यतिपात
व्याधित->व्यधित
व्यवधा->व्यवदा
व्यवधान->व्यवदान
व्यसन->व्यशन
व्याघ्रपाद->व्याघ्रपद
व्याधित->व्यादित
व्यापाद->व्यापद
व्यूत->व्युत
व्यूति->व्युति
व्रातीन->व्रतीन
व्रात्य->व्रत्य
शाकटायन->शकटायन
शाकटिक->शकटिक
शकार->शकर
शकारि->शकरि
शाकुण->शकुर
शाखोट->शकोट
शाक्तीक->शक्तिक
शाक्वर->शक्वर
शङ्खिन्->शङ्किन्
शङ्खनख->शङ्खनक
शाङ्खिक->शङ्खिक
शरमय->शणमय
शरीर->शणीर
शाणीर->शणीर
शारीर->शणीर
शतघ्नी->शतघ्नि
शतधा->शतदा
शतधार->शतधर
शातन->शतन
शातपत्त्रक->शतपत्त्रक
शतपाद्->शतपद्
शतरुद्रीय->शतरुद्रिय
शान->शन
शनैस्->शनैश्
शान्त->शन्त
शान्तनु->शन्तनु
शान्ति->शन्ति
शाब्दबोध->शब्दबोध
शमनस्वसृ->शमनश्वसृ
शमीक->शमिक
शमीर->शमिर
शम्पाक->शम्पक
शम्भ->शंब
शाम्बरी->शंबरी
शाम्बुक->शम्बुक
शम्भु->शम्बू
शाम्बुक->शम्बूक
शाम्भव->शम्भव
शाम्भव->शंभव
शयथ->शयत
शयनैकादशी->शयनैकदशी
शारद->शरद
शराव->शरव
शरी->शरि
शाणि->शरि
शारि->शरि
शार्कर->शर्कर
शार्कर->शर्कार
शर्वरी->शर्वणी
शर्वाणी->शर्वणी
शलाका->शलका
शालि->शली
शाली->शली
शालु->शलु
शाल्मलि->शल्मली
शवर->शवण
शावर->शवण
शासितृ->शसितृ
शास्तृ->शस्तृ
शस्यध्वंसिन्->शस्यध्वंशिन्
शाकटायन->शाकटयन
शाखिन्->शाकिन्
शाखोट->शाकोट
शाक्तीक->शाक्तिक
शाङ्खिक->शाङ्किक
शाठ्य->शाट्य
शारि->शाणी
शानी->शानि
शाम्भव->शाम्बव
शार्दूल->शार्दुल
शालीन->शालिन
शालूर->शालुर
शास->शाश
शिखरिन्->शिकरिन्
शिखियूप->शिखियुप
शिङ्घाण->शिङ्घण
शिफा->शिपा
शिम्बी->शिम्बि
शिरस्->शिरश्
शिलाज->शिलज
शिवचतुर्दशी->शिवचतुर्दशि
शिवाप्रिया->शिवप्रिया
शिष्टाचार->शिष्टचार
शीतपर्णी->शीतपर्णि
शुकनास->शुकनाश
शुकफल->शुकपाल
शूकपिण्डी->शुकपिण्डि
शूकशिम्बा->शुकशिम्बा
शूकशिम्बि->शुकशिम्बि
शूका->शुका
शुठ->शुट
शुर->शुण
शूर->शुण
शुनःशेफ->शुनःशेप
शूना->शुना
शुनासीर->शुनाशीर
शुनी->शुनि
शुभ्र->शुब्र
शुम्भ->शुम्ब
शूर्प->शुर्प
शूकपिण्डी->शूकपिण्डि
शूकापूट्ट->शूकापुट्ट
शूली->शूलि
शॄ->शृ
शृगालिका->शृगलिका
शृङ्गी->शृङ्गि
शृङ्गीकनक->शृङ्गिकनक
शैखरिक->शेखरिक
शैत्य->शेत्य
शेवाल->शेवल
शैवल->शेवल
शैवाल->शेवल
शैवलिनी->शेवलिनी
शैव्य->शेव्य
शौच->शोच
शौड->शोढ
शौरि->शोणी
शौण्ड->शोण्ड
शौण्डी->शोण्डी
शौधिका->शोधिका
शौभ->शोभ
शोली->शोलि
शौण्डी->शौण्डि
शौण्डीर->शौण्डिर
श्राद्ध->श्रद्ध
श्राद्धदेव->श्रद्धादेव
श्राद्धिन्->श्रद्धिन्
श्रावक->श्रवक
श्रीपर्णी->श्रिपर्णि
श्रीश->श्रिश
श्रीताल->श्रीतल
श्रीपर्णी->श्रीपर्णि
श्रीफल->श्रीपाल
श्रै->श्रे
श्रेढी->श्रेडि
श्रेढी->श्रेडी
श्रेष्ठ->श्रेष्ट
श्रौत->श्रोत
श्रौत->श्रोथ
श्रौषट्->श्रोषट्
श्लाख->श्लख
श्लाघ->श्लघ
श्वागणिक->श्वगणिक
श्वपाक->श्वपक
श्वापद->श्वपद
श्वापद->श्वपाद
श्वयीची->श्वयीचि
श्वाविध्->श्वाविद्
श्वेतद्वीप->श्वेतद्विप
श्वेतरथ->श्वेतरत
श्वेतवाह्->श्वेतवह्
श्वेतवाह्->श्वेतवाः
षाट्->षट्
षाण्मासिक->षण्मासिक
षाध->षध
षष्ठ->षष्ट
षष्ठी->षष्टी
षोढा->षोडा
ष्ठा->ष्टा
ष्टूप->ष्टुप
ष्ठ्यूत->ष्ठ्युत
संवास->संवस
संवाहन->संवहन
संविधान->संविदान
संसद्->संशद्
संसार->संशर
संहार->संहर
सकार->सकण
सकार->सकर
सक्थि->सक्ति
सगर->सगण
सङ्कसूक->सङ्कसुक
संघ->संग
सङ्घात->सङ्गथ
संग्राहिन्->संग्रहिन्
सटाङ्क->सटङ्क
सतील->सतिल
सत्कार->सत्कर
सत्यफल->सत्यपाल
सत्यवाच्->सत्यवच्
सधि->सदि
सधिस्->सदिश्
सद्यस्->सद्यश्
सनात्->सनत्
सन्तापन->सन्तपन
सन्धा->सन्दा
सन्नाह्य->सन्नह्य
सपर->सपण
सफर->सपण
सपत्नी->सपत्नि
सफल->सपाल
समादान->समदन
समाधा->समधा
समाधि->समधी
समान->समन
समापन्न->समपान्न
समायोग->समयोग
समालम्भ->समलम्ब
समावृत्त->समवृत्त
समसन->समशन
समाघात->समागत
समाधा->समादा
समास->समाश
समाहार->समाहर
समिथ->समित
समीर->समिर
सामि->समी
समुत्थान->समुत्तान
समूह्य->समुह्य
सम्पाति->सम्पति
सम्प्रसाधन->सम्प्रसादन
सम्प्रसाधन->संप्रसादन
सम्प्रैष->संप्रेष
सम्प्रैष->सम्प्रेष
सम्फाल->सम्फल
सम्फाल->संफल
सम्बाधन->संबधन
सम्भूति->सम्बूति
सम्भार->संभर
सम्भार->सम्भर
सम्भावन->सम्भवन
सम्भावन->संभवन
सांवत्सर->सम्वत्सर
सराव->सरव
सरसीक->सरसिक
सरसीरुह->सरसिरुह
सर्वतस्->सर्वतश्
सर्वथा->सर्वता
सव्येष्ठृ->सव्येष्टृ
सहाय->सहय
सहार->सहर
सहासन->सहसान
सांसारिक->सांसरिक
साक्षात्कार->साक्षात्कर
सांघातिक->सांगतिक
साधक->सादक
साधन->सादन
साधित->सादित
साध्य->साद्य
सामान्य->सामन्य
सामिधेनी->सामिधेनि
सारघ->सारग
सारसन->सारशन
सारिणी->सारिणि
सास्र->साश्र
साहायक->साहयक
सिक्थ->सिक्त
सिताखण्ड->सितखण्ड
सितालता->सितलता
सितसायका->सितशायका
सीमा->सिमा
सीस->सिस
सुख->सुक
सूक->सुक
सूकर->सुकर
सुकाष्ठ->सुकष्ट
सूक्ष्म->सुक्ष्म
सुखचार->सुखचर
सुखावह->सुखवह
सूति->सुति
सूति->सुती
सूत्या->सुत्या
सुधा->सुदा
सूदन->सुदान
सुधिति->सुदिति
सुधिति->सुदीति
सूदन->सुधन
सुधाधार->सुधाधर
सुधास्रवा->सुधाश्रवा
सुधी->सुधि
सून->सुन
सुनासीर->सुनाशीर
सुनीथ->सुनित
सुनीथ->सुनीत
सूनु->सुनु
सूनु->सुनू
सुपूर->सुपुर
सुप्रतीक->सुप्रतिक
सुप्रतिष्ठित->सुप्रतिष्टित
सुभाञ्जन->सुभञ्जन
सूरण->सुरण
सुरदुन्दुभी->सुरदुन्दुभि
सूरसूत->सुरसुत
सूरि->सुरि
सूरि->सुरी
सुवर्णकार->सुवर्णकण
सुवास->सुवश
सुशाक->सुशक
सुसार->सुशर
सुषीम->सुषिम
सुष्ठु->सुष्टु
सूक्ष्मशाख->सूक्ष्मशाक
सूचीमुख->सूचिमुख
सूत्याशौच->सूत्यशौच
सूत्रधार->सूत्रधर
सूरसूत->सूरसुत
सूर्य्यालोक->सूर्य्यलोक
सेनानी->सेनानि
सैनापत्य->सेनापत्य
सैन्य->सेन्य
सौध->सोध
सोपाधि->सोपधि
सौभ->सोभ
सौभरि->सोभरि
सौभरि->सोभरी
सौम्य->सोम्य
सौर->सोर
सौराष्ट्रिक->सोराष्ट्रिक
सौत्रामणी->सौत्रामणि
सौदामनी->सौदामनि
सौभाग्य->सौभग्य
सौराष्ट्र->सौरष्ट्र
सौष्ठव->सौष्टव
स्कन्धफल->स्कन्दपाल
स्कन्धाग्नि->स्कन्दाग्नि
स्कन्धिक->स्कन्दिक
स्कन्धिन्->स्कन्दिन्
स्कन्धवाह->स्कन्धवह
स्थ->स्त
स्थानिन्->स्तनिन्
स्तरी->स्तरि
स्थाणु->स्तरु
स्थावर->स्तवर
स्थवि->स्तवि
स्थग->स्ताघ
स्थामन्->स्तामन्
स्तूप->स्तुप
स्त्री->स्त्रि
स्थान->स्थन
स्थापनी->स्थपनी
स्थलपद्मिनी->स्थलपद्मिनि
स्थूर->स्थुर
स्थूरिन्->स्थुरिन्
स्थूल->स्थुल
स्थूललक्ष->स्थुललक्ष
स्थूर->स्थूण
स्नुह्->स्नुः
स्फर->स्पर
स्फार->स्पर
स्फरण->स्परण
स्फारण->स्परण
स्फाय->स्फय
स्फूर्जक->स्फुर्जक
स्यमीका->स्यमिका
स्राक्->स्रक्
स्रावक->स्रवक
स्वाद->स्वद
स्वाधिष्ठान->स्वधिष्ठान
स्वान्त->स्वन्त
स्वयम्भू->स्वयंभु
स्वायम्भुव->स्वयम्भुव
स्वायम्भुव->स्वयंभुव
स्वाराज्य->स्वराज्य
स्वारोचिष->स्वरोचिष
स्वार्थ->स्वर्त
स्वार्थ->स्वर्थ
स्ववासिनी->स्ववशिनी
स्वस्तिवाचन->स्वस्तिवचन
स्वास्थ्य->स्वस्त्य
स्वादिष्ठ->स्वादिष्ट
स्वीकार->स्वीकर
हंसपाद->हंसपद
हंसपादिका->हंसपदिका
हठपर्णी->हटपर्णी
हर->हण
हनूष->हनुष
हम्भा->हंबा
हम्भा->हम्बा
हारिकण्ठ->हरिकण्ठ
हरीतकी->हरितकी
हारिद्र->हरिद्र
हारिन्->हरिन्
हरिमन्थ->हरिमन्त
हरिवात्->हरिवत्
हारि->हरी
हारितक->हरीतक
हालक->हलक
हलाहल->हलहल
हालहल->हलहल
हालाहल->हलहल
हालिक->हलिक
हालिनी->हलिनी
हव्यवाह->हव्यवह
हासिका->हसिका
हास्तिन->हस्तिन
हस्तिनापुर->हस्तिनपुर
हस्तिनी->हस्तिनि
हास्तिन->हस्तीन
हास्य->हस्य
हालाहल->हालहाल
हालिनी->हालिनि
हिण्डी->हिण्डि
हीन->हिन
हिमावती->हिमवती
हीर->हिर
हीही->हिहि
हील->हीLअ
हीही->हीहि
हूति->हुति
हूहु->हुहू
हृणी->हृणि
हृणीया->हृणिया
हेलन->हेLअन
हेठ->हेट
हैतुक->हेतुक
हेमकार->हेमकर
हैमन->हेमन
हैमवत->हेमवत
हेमशिखा->हेमशिका
हैमा->हेमा
हैहय->हेहय
हेहै->हेहे
हौड->होढ
होत्रीय->होत्रिय
ह्रास->ह्रस
ह्रिणीया->ह्रिणिया
ह्रीवेर->ह्रिवेर
ह्रौड->ह्रोड
